/	tendenci.apps.base.views.homepage	home
/404/reports/	tendenci.apps.perms.decorators.decorator	reports-404-count
/<file_name>	tendenci.apps.base.views.base_file
/<path>	django.views.static.serve
/<slug>/	tendenci.apps.pages.views.index	page
/__debug__/render_panel/	debug_toolbar.views.render_panel	djdt:render_panel
/__debug__/sql_explain/	debug_toolbar.panels.sql.views.sql_explain	djdt:sql_explain
/__debug__/sql_profile/	debug_toolbar.panels.sql.views.sql_profile	djdt:sql_profile
/__debug__/sql_select/	debug_toolbar.panels.sql.views.sql_select	djdt:sql_select
/__debug__/template_source/	debug_toolbar.panels.templates.views.template_source	djdt:template_source
/accountings/account_numbers/	tendenci.apps.accountings.views.account_numbers	accounting.account_numbers
/accounts/activate/<activation_key>/	tendenci.apps.registration.views.activate	registration_activate
/accounts/login/	tendenci.apps.base.decorators.decorator	auth_login
/accounts/logout/	django.contrib.auth.views.LogoutView	auth_logout
/accounts/password/change/<id>/	tendenci.apps.base.decorators.decorator	auth_password_change
/accounts/password/change/done/<id>/	tendenci.apps.profiles.views.password_change_done	auth_password_change_done
/accounts/password/reset/	tendenci.apps.accounts.views.password_reset	auth_password_reset
/accounts/password/reset/complete/	django.contrib.auth.views.PasswordResetCompleteView	password_reset_complete
/accounts/password/reset/confirm/<uidb64>/<token>/	django.contrib.auth.views.PasswordResetConfirmView	password_reset_confirm
/accounts/password/reset/done/	django.contrib.auth.views.PasswordResetDoneView	password_reset_done
/accounts/register/	tendenci.apps.base.decorators.decorator	registration_register
/accounts/register/complete/	django.views.generic.base.TemplateView	registration_complete
/accounts/register/event/<event_id>/	tendenci.apps.base.decorators.decorator	registration_event_register
/admin/	django.contrib.admin.sites.index	admin:index
/admin/<app_label>/	django.contrib.admin.sites.app_index	admin:app_list
/admin/announcements/emergencyannouncement/	django.contrib.admin.options.changelist_view	admin:announcements_emergencyannouncement_changelist
/admin/announcements/emergencyannouncement/<path:object_id>/	django.views.generic.base.RedirectView
/admin/announcements/emergencyannouncement/<path:object_id>/change/	tendenci.apps.perms.admin.change_view	admin:announcements_emergencyannouncement_change
/admin/announcements/emergencyannouncement/<path:object_id>/delete/	django.contrib.admin.options.delete_view	admin:announcements_emergencyannouncement_delete
/admin/announcements/emergencyannouncement/<path:object_id>/history/	django.contrib.admin.options.history_view	admin:announcements_emergencyannouncement_history
/admin/announcements/emergencyannouncement/add/	django.contrib.admin.options.add_view	admin:announcements_emergencyannouncement_add
/admin/announcements/emergencyannouncement/autocomplete/	django.contrib.admin.options.autocomplete_view	admin:announcements_emergencyannouncement_autocomplete
/admin/articles/article/	django.contrib.admin.options.changelist_view	admin:articles_article_changelist
/admin/articles/article/<path:object_id>/	django.views.generic.base.RedirectView
/admin/articles/article/<path:object_id>/change/	tendenci.apps.perms.admin.change_view	admin:articles_article_change
/admin/articles/article/<path:object_id>/delete/	django.contrib.admin.options.delete_view	admin:articles_article_delete
/admin/articles/article/<path:object_id>/history/	django.contrib.admin.options.history_view	admin:articles_article_history
/admin/articles/article/add/	django.contrib.admin.options.add_view	admin:articles_article_add
/admin/articles/article/autocomplete/	django.contrib.admin.options.autocomplete_view	admin:articles_article_autocomplete
/admin/auth/user/	django.contrib.admin.options.changelist_view	admin:auth_user_changelist
/admin/auth/user/<id>/password/	django.contrib.auth.admin.user_change_password	admin:auth_user_password_change
/admin/auth/user/<path:object_id>/	django.views.generic.base.RedirectView
/admin/auth/user/<path:object_id>/change/	django.contrib.admin.options.change_view	admin:auth_user_change
/admin/auth/user/<path:object_id>/delete/	django.contrib.admin.options.delete_view	admin:auth_user_delete
/admin/auth/user/<path:object_id>/history/	django.contrib.admin.options.history_view	admin:auth_user_history
/admin/auth/user/add/	django.contrib.auth.admin.add_view	admin:auth_user_add
/admin/auth/user/autocomplete/	django.contrib.admin.options.autocomplete_view	admin:auth_user_autocomplete
/admin/boxes/box/	django.contrib.admin.options.changelist_view	admin:boxes_box_changelist
/admin/boxes/box/<path:object_id>/	django.views.generic.base.RedirectView
/admin/boxes/box/<path:object_id>/change/	tendenci.apps.perms.admin.change_view	admin:boxes_box_change
/admin/boxes/box/<path:object_id>/delete/	django.contrib.admin.options.delete_view	admin:boxes_box_delete
/admin/boxes/box/<path:object_id>/history/	django.contrib.admin.options.history_view	admin:boxes_box_history
/admin/boxes/box/add/	django.contrib.admin.options.add_view	admin:boxes_box_add
/admin/boxes/box/autocomplete/	django.contrib.admin.options.autocomplete_view	admin:boxes_box_autocomplete
/admin/careers/career/	django.contrib.admin.options.changelist_view	admin:careers_career_changelist
/admin/careers/career/<path:object_id>/	django.views.generic.base.RedirectView
/admin/careers/career/<path:object_id>/change/	tendenci.apps.perms.admin.change_view	admin:careers_career_change
/admin/careers/career/<path:object_id>/delete/	django.contrib.admin.options.delete_view	admin:careers_career_delete
/admin/careers/career/<path:object_id>/history/	django.contrib.admin.options.history_view	admin:careers_career_history
/admin/careers/career/add/	django.contrib.admin.options.add_view	admin:careers_career_add
/admin/careers/career/autocomplete/	django.contrib.admin.options.autocomplete_view	admin:careers_career_autocomplete
/admin/case_studies/casestudy/	django.contrib.admin.options.changelist_view	admin:case_studies_casestudy_changelist
/admin/case_studies/casestudy/<path:object_id>/	django.views.generic.base.RedirectView
/admin/case_studies/casestudy/<path:object_id>/change/	tendenci.apps.perms.admin.change_view	admin:case_studies_casestudy_change
/admin/case_studies/casestudy/<path:object_id>/delete/	django.contrib.admin.options.delete_view	admin:case_studies_casestudy_delete
/admin/case_studies/casestudy/<path:object_id>/history/	django.contrib.admin.options.history_view	admin:case_studies_casestudy_history
/admin/case_studies/casestudy/add/	django.contrib.admin.options.add_view	admin:case_studies_casestudy_add
/admin/case_studies/casestudy/autocomplete/	django.contrib.admin.options.autocomplete_view	admin:case_studies_casestudy_autocomplete
/admin/case_studies/image/	django.contrib.admin.options.changelist_view	admin:case_studies_image_changelist
/admin/case_studies/image/<path:object_id>/	django.views.generic.base.RedirectView
/admin/case_studies/image/<path:object_id>/change/	django.contrib.admin.options.change_view	admin:case_studies_image_change
/admin/case_studies/image/<path:object_id>/delete/	django.contrib.admin.options.delete_view	admin:case_studies_image_delete
/admin/case_studies/image/<path:object_id>/history/	django.contrib.admin.options.history_view	admin:case_studies_image_history
/admin/case_studies/image/add/	django.contrib.admin.options.add_view	admin:case_studies_image_add
/admin/case_studies/image/autocomplete/	django.contrib.admin.options.autocomplete_view	admin:case_studies_image_autocomplete
/admin/categories/category/	django.contrib.admin.options.changelist_view	admin:categories_category_changelist
/admin/categories/category/<path:object_id>/	django.views.generic.base.RedirectView
/admin/categories/category/<path:object_id>/change/	django.contrib.admin.options.change_view	admin:categories_category_change
/admin/categories/category/<path:object_id>/delete/	django.contrib.admin.options.delete_view	admin:categories_category_delete
/admin/categories/category/<path:object_id>/history/	django.contrib.admin.options.history_view	admin:categories_category_history
/admin/categories/category/add/	django.contrib.admin.options.add_view	admin:categories_category_add
/admin/categories/category/autocomplete/	django.contrib.admin.options.autocomplete_view	admin:categories_category_autocomplete
/admin/categories/categoryitem/	django.contrib.admin.options.changelist_view	admin:categories_categoryitem_changelist
/admin/categories/categoryitem/<path:object_id>/	django.views.generic.base.RedirectView
/admin/categories/categoryitem/<path:object_id>/change/	django.contrib.admin.options.change_view	admin:categories_categoryitem_change
/admin/categories/categoryitem/<path:object_id>/delete/	django.contrib.admin.options.delete_view	admin:categories_categoryitem_delete
/admin/categories/categoryitem/<path:object_id>/history/	django.contrib.admin.options.history_view	admin:categories_categoryitem_history
/admin/categories/categoryitem/add/	django.contrib.admin.options.add_view	admin:categories_categoryitem_add
/admin/categories/categoryitem/autocomplete/	django.contrib.admin.options.autocomplete_view	admin:categories_categoryitem_autocomplete
/admin/committees/committee/	django.contrib.admin.options.changelist_view	admin:committees_committee_changelist
/admin/committees/committee/<path:object_id>/	django.views.generic.base.RedirectView
/admin/committees/committee/<path:object_id>/change/	tendenci.apps.perms.admin.change_view	admin:committees_committee_change
/admin/committees/committee/<path:object_id>/delete/	django.contrib.admin.options.delete_view	admin:committees_committee_delete
/admin/committees/committee/<path:object_id>/history/	django.contrib.admin.options.history_view	admin:committees_committee_history
/admin/committees/committee/add/	django.contrib.admin.options.add_view	admin:committees_committee_add
/admin/committees/committee/autocomplete/	django.contrib.admin.options.autocomplete_view	admin:committees_committee_autocomplete
/admin/committees/position/	django.contrib.admin.options.changelist_view	admin:committees_position_changelist
/admin/committees/position/<path:object_id>/	django.views.generic.base.RedirectView
/admin/committees/position/<path:object_id>/change/	django.contrib.admin.options.change_view	admin:committees_position_change
/admin/committees/position/<path:object_id>/delete/	django.contrib.admin.options.delete_view	admin:committees_position_delete
/admin/committees/position/<path:object_id>/history/	django.contrib.admin.options.history_view	admin:committees_position_history
/admin/committees/position/add/	django.contrib.admin.options.add_view	admin:committees_position_add
/admin/committees/position/autocomplete/	django.contrib.admin.options.autocomplete_view	admin:committees_position_autocomplete
/admin/contacts/contact/	django.contrib.admin.options.changelist_view	admin:contacts_contact_changelist
/admin/contacts/contact/<path:object_id>/	django.views.generic.base.RedirectView
/admin/contacts/contact/<path:object_id>/change/	tendenci.apps.perms.admin.change_view	admin:contacts_contact_change
/admin/contacts/contact/<path:object_id>/delete/	django.contrib.admin.options.delete_view	admin:contacts_contact_delete
/admin/contacts/contact/<path:object_id>/history/	django.contrib.admin.options.history_view	admin:contacts_contact_history
/admin/contacts/contact/add/	django.contrib.admin.options.add_view	admin:contacts_contact_add
/admin/contacts/contact/autocomplete/	django.contrib.admin.options.autocomplete_view	admin:contacts_contact_autocomplete
/admin/corporate_memberships/corpmembership/	django.contrib.admin.options.changelist_view	admin:corporate_memberships_corpmembership_changelist
/admin/corporate_memberships/corpmembership/<path:object_id>/	django.views.generic.base.RedirectView
/admin/corporate_memberships/corpmembership/<path:object_id>/change/	tendenci.apps.corporate_memberships.admin.change_view	admin:corporate_memberships_corpmembership_change
/admin/corporate_memberships/corpmembership/<path:object_id>/delete/	django.contrib.admin.options.delete_view	admin:corporate_memberships_corpmembership_delete
/admin/corporate_memberships/corpmembership/<path:object_id>/history/	django.contrib.admin.options.history_view	admin:corporate_memberships_corpmembership_history
/admin/corporate_memberships/corpmembership/add/	tendenci.apps.corporate_memberships.admin.add_view	admin:corporate_memberships_corpmembership_add
/admin/corporate_memberships/corpmembership/autocomplete/	django.contrib.admin.options.autocomplete_view	admin:corporate_memberships_corpmembership_autocomplete
/admin/corporate_memberships/corpmembershipapp/	django.contrib.admin.options.changelist_view	admin:corporate_memberships_corpmembershipapp_changelist
/admin/corporate_memberships/corpmembershipapp/<path:object_id>/	django.views.generic.base.RedirectView
/admin/corporate_memberships/corpmembershipapp/<path:object_id>/change/	django.contrib.admin.options.change_view	admin:corporate_memberships_corpmembershipapp_change
/admin/corporate_memberships/corpmembershipapp/<path:object_id>/delete/	django.contrib.admin.options.delete_view	admin:corporate_memberships_corpmembershipapp_delete
/admin/corporate_memberships/corpmembershipapp/<path:object_id>/history/	django.contrib.admin.options.history_view	admin:corporate_memberships_corpmembershipapp_history
/admin/corporate_memberships/corpmembershipapp/add/	django.contrib.admin.options.add_view	admin:corporate_memberships_corpmembershipapp_add
/admin/corporate_memberships/corpmembershipapp/autocomplete/	django.contrib.admin.options.autocomplete_view	admin:corporate_memberships_corpmembershipapp_autocomplete
/admin/corporate_memberships/corpmembershipappfield/	django.contrib.admin.options.changelist_view	admin:corporate_memberships_corpmembershipappfield_changelist
/admin/corporate_memberships/corpmembershipappfield/<path:object_id>/	django.views.generic.base.RedirectView
/admin/corporate_memberships/corpmembershipappfield/<path:object_id>/change/	django.contrib.admin.options.change_view	admin:corporate_memberships_corpmembershipappfield_change
/admin/corporate_memberships/corpmembershipappfield/<path:object_id>/delete/	django.contrib.admin.options.delete_view	admin:corporate_memberships_corpmembershipappfield_delete
/admin/corporate_memberships/corpmembershipappfield/<path:object_id>/history/	django.contrib.admin.options.history_view	admin:corporate_memberships_corpmembershipappfield_history
/admin/corporate_memberships/corpmembershipappfield/add/	django.contrib.admin.options.add_view	admin:corporate_memberships_corpmembershipappfield_add
/admin/corporate_memberships/corpmembershipappfield/autocomplete/	django.contrib.admin.options.autocomplete_view	admin:corporate_memberships_corpmembershipappfield_autocomplete
/admin/corporate_memberships/corpmembershiprep/	django.contrib.admin.options.changelist_view	admin:corporate_memberships_corpmembershiprep_changelist
/admin/corporate_memberships/corpmembershiprep/<path:object_id>/	django.views.generic.base.RedirectView
/admin/corporate_memberships/corpmembershiprep/<path:object_id>/change/	django.contrib.admin.options.change_view	admin:corporate_memberships_corpmembershiprep_change
/admin/corporate_memberships/corpmembershiprep/<path:object_id>/delete/	django.contrib.admin.options.delete_view	admin:corporate_memberships_corpmembershiprep_delete
/admin/corporate_memberships/corpmembershiprep/<path:object_id>/history/	django.contrib.admin.options.history_view	admin:corporate_memberships_corpmembershiprep_history
/admin/corporate_memberships/corpmembershiprep/add/	django.contrib.admin.options.add_view	admin:corporate_memberships_corpmembershiprep_add
/admin/corporate_memberships/corpmembershiprep/autocomplete/	django.contrib.admin.options.autocomplete_view	admin:corporate_memberships_corpmembershiprep_autocomplete
/admin/corporate_memberships/corporatemembershiptype/	django.contrib.admin.options.changelist_view	admin:corporate_memberships_corporatemembershiptype_changelist
/admin/corporate_memberships/corporatemembershiptype/<path:object_id>/	django.views.generic.base.RedirectView
/admin/corporate_memberships/corporatemembershiptype/<path:object_id>/change/	tendenci.apps.perms.admin.change_view	admin:corporate_memberships_corporatemembershiptype_change
/admin/corporate_memberships/corporatemembershiptype/<path:object_id>/delete/	django.contrib.admin.options.delete_view	admin:corporate_memberships_corporatemembershiptype_delete
/admin/corporate_memberships/corporatemembershiptype/<path:object_id>/history/	django.contrib.admin.options.history_view	admin:corporate_memberships_corporatemembershiptype_history
/admin/corporate_memberships/corporatemembershiptype/add/	django.contrib.admin.options.add_view	admin:corporate_memberships_corporatemembershiptype_add
/admin/corporate_memberships/corporatemembershiptype/autocomplete/	django.contrib.admin.options.autocomplete_view	admin:corporate_memberships_corporatemembershiptype_autocomplete
/admin/corporate_memberships/corpprofile/	django.contrib.admin.options.changelist_view	admin:corporate_memberships_corpprofile_changelist
/admin/corporate_memberships/corpprofile/<path:object_id>/	django.views.generic.base.RedirectView
/admin/corporate_memberships/corpprofile/<path:object_id>/change/	tendenci.apps.perms.admin.change_view	admin:corporate_memberships_corpprofile_change
/admin/corporate_memberships/corpprofile/<path:object_id>/delete/	django.contrib.admin.options.delete_view	admin:corporate_memberships_corpprofile_delete
/admin/corporate_memberships/corpprofile/<path:object_id>/history/	django.contrib.admin.options.history_view	admin:corporate_memberships_corpprofile_history
/admin/corporate_memberships/corpprofile/add/	django.contrib.admin.options.add_view	admin:corporate_memberships_corpprofile_add
/admin/corporate_memberships/corpprofile/autocomplete/	django.contrib.admin.options.autocomplete_view	admin:corporate_memberships_corpprofile_autocomplete
/admin/corporate_memberships/notice/	django.contrib.admin.options.changelist_view	admin:corporate_memberships_notice_changelist
/admin/corporate_memberships/notice/<path:object_id>/	django.views.generic.base.RedirectView
/admin/corporate_memberships/notice/<path:object_id>/change/	django.contrib.admin.options.change_view	admin:corporate_memberships_notice_change
/admin/corporate_memberships/notice/<path:object_id>/delete/	django.contrib.admin.options.delete_view	admin:corporate_memberships_notice_delete
/admin/corporate_memberships/notice/<path:object_id>/history/	django.contrib.admin.options.history_view	admin:corporate_memberships_notice_history
/admin/corporate_memberships/notice/add/	django.contrib.admin.options.add_view	admin:corporate_memberships_notice_add
/admin/corporate_memberships/notice/autocomplete/	django.contrib.admin.options.autocomplete_view	admin:corporate_memberships_notice_autocomplete
/admin/corporate_memberships/notice/clone/<pk>/	tendenci.apps.corporate_memberships.admin.clone	admin:corporate_membership_notice.admin_clone
/admin/directories/category/	django.contrib.admin.options.changelist_view	admin:directories_category_changelist
/admin/directories/category/<path:object_id>/	django.views.generic.base.RedirectView
/admin/directories/category/<path:object_id>/change/	django.contrib.admin.options.change_view	admin:directories_category_change
/admin/directories/category/<path:object_id>/delete/	django.contrib.admin.options.delete_view	admin:directories_category_delete
/admin/directories/category/<path:object_id>/history/	django.contrib.admin.options.history_view	admin:directories_category_history
/admin/directories/category/add/	django.contrib.admin.options.add_view	admin:directories_category_add
/admin/directories/category/autocomplete/	django.contrib.admin.options.autocomplete_view	admin:directories_category_autocomplete
/admin/directories/directory/	import_export.admin.changelist_view	admin:directories_directory_changelist
/admin/directories/directory/<path:object_id>/	django.views.generic.base.RedirectView
/admin/directories/directory/<path:object_id>/change/	django.contrib.admin.options.change_view	admin:directories_directory_change
/admin/directories/directory/<path:object_id>/delete/	django.contrib.admin.options.delete_view	admin:directories_directory_delete
/admin/directories/directory/<path:object_id>/history/	django.contrib.admin.options.history_view	admin:directories_directory_history
/admin/directories/directory/add/	django.contrib.admin.options.add_view	admin:directories_directory_add
/admin/directories/directory/autocomplete/	django.contrib.admin.options.autocomplete_view	admin:directories_directory_autocomplete
/admin/directories/directory/export/	import_export.admin.export_action	admin:directories_directory_export
/admin/directories/directory/import/	import_export.admin.import_action	admin:directories_directory_import
/admin/directories/directory/process_import/	import_export.admin.process_import	admin:directories_directory_process_import
/admin/directories/directorypricing/	django.contrib.admin.options.changelist_view	admin:directories_directorypricing_changelist
/admin/directories/directorypricing/<path:object_id>/	django.views.generic.base.RedirectView
/admin/directories/directorypricing/<path:object_id>/change/	django.contrib.admin.options.change_view	admin:directories_directorypricing_change
/admin/directories/directorypricing/<path:object_id>/delete/	django.contrib.admin.options.delete_view	admin:directories_directorypricing_delete
/admin/directories/directorypricing/<path:object_id>/history/	django.contrib.admin.options.history_view	admin:directories_directorypricing_history
/admin/directories/directorypricing/add/	django.contrib.admin.options.add_view	admin:directories_directorypricing_add
/admin/directories/directorypricing/autocomplete/	django.contrib.admin.options.autocomplete_view	admin:directories_directorypricing_autocomplete
/admin/doc/	django.contrib.admindocs.views.BaseAdminDocsView	django-admindocs-docroot
/admin/doc/bookmarklets/	django.contrib.admindocs.views.BookmarkletsView	django-admindocs-bookmarklets
/admin/doc/filters/	django.contrib.admindocs.views.TemplateFilterIndexView	django-admindocs-filters
/admin/doc/models/	django.contrib.admindocs.views.ModelIndexView	django-admindocs-models-index
/admin/doc/models/<app_label>\.<model_name>/	django.contrib.admindocs.views.ModelDetailView	django-admindocs-models-detail
/admin/doc/tags/	django.contrib.admindocs.views.TemplateTagIndexView	django-admindocs-tags
/admin/doc/templates/<path:template>/	django.contrib.admindocs.views.TemplateDetailView	django-admindocs-templates
/admin/doc/views/	django.contrib.admindocs.views.ViewIndexView	django-admindocs-views-index
/admin/doc/views/<view>/	django.contrib.admindocs.views.ViewDetailView	django-admindocs-views-detail
/admin/drone_hangar/airbnbdata/	django.contrib.admin.options.changelist_view	admin:drone_hangar_airbnbdata_changelist
/admin/drone_hangar/airbnbdata/<path:object_id>/	django.views.generic.base.RedirectView
/admin/drone_hangar/airbnbdata/<path:object_id>/change/	django.contrib.admin.options.change_view	admin:drone_hangar_airbnbdata_change
/admin/drone_hangar/airbnbdata/<path:object_id>/delete/	django.contrib.admin.options.delete_view	admin:drone_hangar_airbnbdata_delete
/admin/drone_hangar/airbnbdata/<path:object_id>/history/	django.contrib.admin.options.history_view	admin:drone_hangar_airbnbdata_history
/admin/drone_hangar/airbnbdata/add/	django.contrib.admin.options.add_view	admin:drone_hangar_airbnbdata_add
/admin/drone_hangar/airbnbdata/autocomplete/	django.contrib.admin.options.autocomplete_view	admin:drone_hangar_airbnbdata_autocomplete
/admin/educations/education/	django.contrib.admin.options.changelist_view	admin:educations_education_changelist
/admin/educations/education/<path:object_id>/	django.views.generic.base.RedirectView
/admin/educations/education/<path:object_id>/change/	tendenci.apps.perms.admin.change_view	admin:educations_education_change
/admin/educations/education/<path:object_id>/delete/	django.contrib.admin.options.delete_view	admin:educations_education_delete
/admin/educations/education/<path:object_id>/history/	django.contrib.admin.options.history_view	admin:educations_education_history
/admin/educations/education/add/	django.contrib.admin.options.add_view	admin:educations_education_add
/admin/educations/education/autocomplete/	django.contrib.admin.options.autocomplete_view	admin:educations_education_autocomplete
/admin/email_blocks/emailblock/	django.contrib.admin.options.changelist_view	admin:email_blocks_emailblock_changelist
/admin/email_blocks/emailblock/<path:object_id>/	django.views.generic.base.RedirectView
/admin/email_blocks/emailblock/<path:object_id>/change/	tendenci.apps.perms.admin.change_view	admin:email_blocks_emailblock_change
/admin/email_blocks/emailblock/<path:object_id>/delete/	django.contrib.admin.options.delete_view	admin:email_blocks_emailblock_delete
/admin/email_blocks/emailblock/<path:object_id>/history/	django.contrib.admin.options.history_view	admin:email_blocks_emailblock_history
/admin/email_blocks/emailblock/add/	django.contrib.admin.options.add_view	admin:email_blocks_emailblock_add
/admin/email_blocks/emailblock/autocomplete/	django.contrib.admin.options.autocomplete_view	admin:email_blocks_emailblock_autocomplete
/admin/emails/email/	django.contrib.admin.options.changelist_view	admin:emails_email_changelist
/admin/emails/email/<path:object_id>/	django.views.generic.base.RedirectView
/admin/emails/email/<path:object_id>/change/	django.contrib.admin.options.change_view	admin:emails_email_change
/admin/emails/email/<path:object_id>/delete/	django.contrib.admin.options.delete_view	admin:emails_email_delete
/admin/emails/email/<path:object_id>/history/	django.contrib.admin.options.history_view	admin:emails_email_history
/admin/emails/email/add/	django.contrib.admin.options.add_view	admin:emails_email_add
/admin/emails/email/autocomplete/	django.contrib.admin.options.autocomplete_view	admin:emails_email_autocomplete
/admin/entities/entity/	django.contrib.admin.options.changelist_view	admin:entities_entity_changelist
/admin/entities/entity/<path:object_id>/	django.views.generic.base.RedirectView
/admin/entities/entity/<path:object_id>/change/	django.contrib.admin.options.change_view	admin:entities_entity_change
/admin/entities/entity/<path:object_id>/delete/	django.contrib.admin.options.delete_view	admin:entities_entity_delete
/admin/entities/entity/<path:object_id>/history/	django.contrib.admin.options.history_view	admin:entities_entity_history
/admin/entities/entity/add/	django.contrib.admin.options.add_view	admin:entities_entity_add
/admin/entities/entity/autocomplete/	django.contrib.admin.options.autocomplete_view	admin:entities_entity_autocomplete
/admin/events/customregform/	django.contrib.admin.options.changelist_view	admin:events_customregform_changelist
/admin/events/customregform/<path:object_id>/	django.views.generic.base.RedirectView
/admin/events/customregform/<path:object_id>/change/	tendenci.apps.events.admin.change_view	admin:events_customregform_change
/admin/events/customregform/<path:object_id>/delete/	django.contrib.admin.options.delete_view	admin:events_customregform_delete
/admin/events/customregform/<path:object_id>/history/	django.contrib.admin.options.history_view	admin:events_customregform_history
/admin/events/customregform/add/	django.contrib.admin.options.add_view	admin:events_customregform_add
/admin/events/customregform/autocomplete/	django.contrib.admin.options.autocomplete_view	admin:events_customregform_autocomplete
/admin/events/customregform/export/<regform_id>/	tendenci.apps.events.admin.export_view	admin:customregform_export
/admin/events/event/	django.contrib.admin.options.changelist_view	admin:events_event_changelist
/admin/events/event/<path:object_id>/	django.views.generic.base.RedirectView
/admin/events/event/<path:object_id>/change/	tendenci.apps.events.admin.change_view	admin:events_event_change
/admin/events/event/<path:object_id>/delete/	django.contrib.admin.options.delete_view	admin:events_event_delete
/admin/events/event/<path:object_id>/history/	django.contrib.admin.options.history_view	admin:events_event_history
/admin/events/event/add/	django.contrib.admin.options.add_view	admin:events_event_add
/admin/events/event/autocomplete/	django.contrib.admin.options.autocomplete_view	admin:events_event_autocomplete
/admin/events/standardregform/	tendenci.apps.events.admin.changelist_view	admin:events_standardregform_changelist
/admin/events/standardregform/<path:object_id>/	django.views.generic.base.RedirectView
/admin/events/standardregform/<path:object_id>/change/	django.contrib.admin.options.change_view	admin:events_standardregform_change
/admin/events/standardregform/<path:object_id>/delete/	django.contrib.admin.options.delete_view	admin:events_standardregform_delete
/admin/events/standardregform/<path:object_id>/history/	django.contrib.admin.options.history_view	admin:events_standardregform_history
/admin/events/standardregform/add/	django.contrib.admin.options.add_view	admin:events_standardregform_add
/admin/events/standardregform/autocomplete/	django.contrib.admin.options.autocomplete_view	admin:events_standardregform_autocomplete
/admin/events/standardregform/edit	tendenci.apps.events.admin.edit_regform_view	admin:standardregform_edit
/admin/events/type/	django.contrib.admin.options.changelist_view	admin:events_type_changelist
/admin/events/type/<path:object_id>/	django.views.generic.base.RedirectView
/admin/events/type/<path:object_id>/change/	django.contrib.admin.options.change_view	admin:events_type_change
/admin/events/type/<path:object_id>/delete/	django.contrib.admin.options.delete_view	admin:events_type_delete
/admin/events/type/<path:object_id>/history/	django.contrib.admin.options.history_view	admin:events_type_history
/admin/events/type/add/	django.contrib.admin.options.add_view	admin:events_type_add
/admin/events/type/autocomplete/	django.contrib.admin.options.autocomplete_view	admin:events_type_autocomplete
/admin/explorer/query/	django.contrib.admin.options.changelist_view	admin:explorer_query_changelist
/admin/explorer/query/<path:object_id>/	django.views.generic.base.RedirectView
/admin/explorer/query/<path:object_id>/change/	django.contrib.admin.options.change_view	admin:explorer_query_change
/admin/explorer/query/<path:object_id>/delete/	django.contrib.admin.options.delete_view	admin:explorer_query_delete
/admin/explorer/query/<path:object_id>/history/	django.contrib.admin.options.history_view	admin:explorer_query_history
/admin/explorer/query/add/	django.contrib.admin.options.add_view	admin:explorer_query_add
/admin/explorer/query/autocomplete/	django.contrib.admin.options.autocomplete_view	admin:explorer_query_autocomplete
/admin/exports/export/	django.contrib.admin.options.changelist_view	admin:exports_export_changelist
/admin/exports/export/<path:object_id>/	django.views.generic.base.RedirectView
/admin/exports/export/<path:object_id>/change/	django.contrib.admin.options.change_view	admin:exports_export_change
/admin/exports/export/<path:object_id>/delete/	django.contrib.admin.options.delete_view	admin:exports_export_delete
/admin/exports/export/<path:object_id>/history/	django.contrib.admin.options.history_view	admin:exports_export_history
/admin/exports/export/add/	django.contrib.admin.options.add_view	admin:exports_export_add
/admin/exports/export/autocomplete/	django.contrib.admin.options.autocomplete_view	admin:exports_export_autocomplete
/admin/files/file/	tendenci.apps.files.admin.changelist_view	admin:files_file_changelist
/admin/files/file/<path:object_id>/	django.views.generic.base.RedirectView
/admin/files/file/<path:object_id>/change/	tendenci.apps.perms.admin.change_view	admin:files_file_change
/admin/files/file/<path:object_id>/delete/	django.contrib.admin.options.delete_view	admin:files_file_delete
/admin/files/file/<path:object_id>/history/	django.contrib.admin.options.history_view	admin:files_file_history
/admin/files/file/add/	django.contrib.admin.options.add_view	admin:files_file_add
/admin/files/file/autocomplete/	django.contrib.admin.options.autocomplete_view	admin:files_file_autocomplete
/admin/files/filescategory/	django.contrib.admin.options.changelist_view	admin:files_filescategory_changelist
/admin/files/filescategory/<path:object_id>/	django.views.generic.base.RedirectView
/admin/files/filescategory/<path:object_id>/change/	django.contrib.admin.options.change_view	admin:files_filescategory_change
/admin/files/filescategory/<path:object_id>/delete/	django.contrib.admin.options.delete_view	admin:files_filescategory_delete
/admin/files/filescategory/<path:object_id>/history/	django.contrib.admin.options.history_view	admin:files_filescategory_history
/admin/files/filescategory/add/	django.contrib.admin.options.add_view	admin:files_filescategory_add
/admin/files/filescategory/autocomplete/	django.contrib.admin.options.autocomplete_view	admin:files_filescategory_autocomplete
/admin/files/multiplefile/	tendenci.apps.files.admin.changelist_view	admin:files_multiplefile_changelist
/admin/files/multiplefile/<path:object_id>/	django.views.generic.base.RedirectView
/admin/files/multiplefile/<path:object_id>/change/	django.contrib.admin.options.change_view	admin:files_multiplefile_change
/admin/files/multiplefile/<path:object_id>/delete/	django.contrib.admin.options.delete_view	admin:files_multiplefile_delete
/admin/files/multiplefile/<path:object_id>/history/	django.contrib.admin.options.history_view	admin:files_multiplefile_history
/admin/files/multiplefile/add	tendenci.apps.files.admin.add_multiple_file_view	admin:multiplefile_add
/admin/files/multiplefile/add/	django.contrib.admin.options.add_view	admin:files_multiplefile_add
/admin/files/multiplefile/autocomplete/	django.contrib.admin.options.autocomplete_view	admin:files_multiplefile_autocomplete
/admin/forms/form/	django.contrib.admin.options.changelist_view	admin:forms_form_changelist
/admin/forms/form/<path:object_id>/	django.views.generic.base.RedirectView
/admin/forms/form/<path:object_id>/change/	tendenci.apps.forms_builder.forms.admin.change_view	admin:forms_form_change
/admin/forms/form/<path:object_id>/delete/	django.contrib.admin.options.delete_view	admin:forms_form_delete
/admin/forms/form/<path:object_id>/history/	django.contrib.admin.options.history_view	admin:forms_form_history
/admin/forms/form/add/	django.contrib.admin.options.add_view	admin:forms_form_add
/admin/forms/form/autocomplete/	django.contrib.admin.options.autocomplete_view	admin:forms_form_autocomplete
/admin/forms/form/export/<form_id>/	tendenci.apps.forms_builder.forms.admin.export_view	admin:forms_form_export
/admin/forms/form/file/<field_entry_id>/	tendenci.apps.forms_builder.forms.admin.file_view	admin:forms_form_file
/admin/forms/formentry/	django.contrib.admin.options.changelist_view	admin:forms_formentry_changelist
/admin/forms/formentry/<path:object_id>/	django.views.generic.base.RedirectView
/admin/forms/formentry/<path:object_id>/change/	tendenci.apps.forms_builder.forms.admin.change_view	admin:forms_formentry_change
/admin/forms/formentry/<path:object_id>/delete/	django.contrib.admin.options.delete_view	admin:forms_formentry_delete
/admin/forms/formentry/<path:object_id>/history/	django.contrib.admin.options.history_view	admin:forms_formentry_history
/admin/forms/formentry/add/	django.contrib.admin.options.add_view	admin:forms_formentry_add
/admin/forms/formentry/autocomplete/	django.contrib.admin.options.autocomplete_view	admin:forms_formentry_autocomplete
/admin/forums/attachment/	django.contrib.admin.options.changelist_view	admin:forums_attachment_changelist
/admin/forums/attachment/<path:object_id>/	django.views.generic.base.RedirectView
/admin/forums/attachment/<path:object_id>/change/	django.contrib.admin.options.change_view	admin:forums_attachment_change
/admin/forums/attachment/<path:object_id>/delete/	django.contrib.admin.options.delete_view	admin:forums_attachment_delete
/admin/forums/attachment/<path:object_id>/history/	django.contrib.admin.options.history_view	admin:forums_attachment_history
/admin/forums/attachment/add/	django.contrib.admin.options.add_view	admin:forums_attachment_add
/admin/forums/attachment/autocomplete/	django.contrib.admin.options.autocomplete_view	admin:forums_attachment_autocomplete
/admin/forums/category/	django.contrib.admin.options.changelist_view	admin:forums_category_changelist
/admin/forums/category/<path:object_id>/	django.views.generic.base.RedirectView
/admin/forums/category/<path:object_id>/change/	django.contrib.admin.options.change_view	admin:forums_category_change
/admin/forums/category/<path:object_id>/delete/	django.contrib.admin.options.delete_view	admin:forums_category_delete
/admin/forums/category/<path:object_id>/history/	django.contrib.admin.options.history_view	admin:forums_category_history
/admin/forums/category/add/	django.contrib.admin.options.add_view	admin:forums_category_add
/admin/forums/category/autocomplete/	django.contrib.admin.options.autocomplete_view	admin:forums_category_autocomplete
/admin/forums/forum/	django.contrib.admin.options.changelist_view	admin:forums_forum_changelist
/admin/forums/forum/<path:object_id>/	django.views.generic.base.RedirectView
/admin/forums/forum/<path:object_id>/change/	django.contrib.admin.options.change_view	admin:forums_forum_change
/admin/forums/forum/<path:object_id>/delete/	django.contrib.admin.options.delete_view	admin:forums_forum_delete
/admin/forums/forum/<path:object_id>/history/	django.contrib.admin.options.history_view	admin:forums_forum_history
/admin/forums/forum/add/	django.contrib.admin.options.add_view	admin:forums_forum_add
/admin/forums/forum/autocomplete/	django.contrib.admin.options.autocomplete_view	admin:forums_forum_autocomplete
/admin/forums/post/	django.contrib.admin.options.changelist_view	admin:forums_post_changelist
/admin/forums/post/<path:object_id>/	django.views.generic.base.RedirectView
/admin/forums/post/<path:object_id>/change/	django.contrib.admin.options.change_view	admin:forums_post_change
/admin/forums/post/<path:object_id>/delete/	django.contrib.admin.options.delete_view	admin:forums_post_delete
/admin/forums/post/<path:object_id>/history/	django.contrib.admin.options.history_view	admin:forums_post_history
/admin/forums/post/add/	django.contrib.admin.options.add_view	admin:forums_post_add
/admin/forums/post/autocomplete/	django.contrib.admin.options.autocomplete_view	admin:forums_post_autocomplete
/admin/forums/profile/	django.contrib.admin.options.changelist_view	admin:forums_profile_changelist
/admin/forums/profile/<path:object_id>/	django.views.generic.base.RedirectView
/admin/forums/profile/<path:object_id>/change/	django.contrib.admin.options.change_view	admin:forums_profile_change
/admin/forums/profile/<path:object_id>/delete/	django.contrib.admin.options.delete_view	admin:forums_profile_delete
/admin/forums/profile/<path:object_id>/history/	django.contrib.admin.options.history_view	admin:forums_profile_history
/admin/forums/profile/add/	django.contrib.admin.options.add_view	admin:forums_profile_add
/admin/forums/profile/autocomplete/	django.contrib.admin.options.autocomplete_view	admin:forums_profile_autocomplete
/admin/forums/topic/	django.contrib.admin.options.changelist_view	admin:forums_topic_changelist
/admin/forums/topic/<path:object_id>/	django.views.generic.base.RedirectView
/admin/forums/topic/<path:object_id>/change/	django.contrib.admin.options.change_view	admin:forums_topic_change
/admin/forums/topic/<path:object_id>/delete/	django.contrib.admin.options.delete_view	admin:forums_topic_delete
/admin/forums/topic/<path:object_id>/history/	django.contrib.admin.options.history_view	admin:forums_topic_history
/admin/forums/topic/add/	django.contrib.admin.options.add_view	admin:forums_topic_add
/admin/forums/topic/autocomplete/	django.contrib.admin.options.autocomplete_view	admin:forums_topic_autocomplete
/admin/help_files/helpfile/	django.contrib.admin.options.changelist_view	admin:help_files_helpfile_changelist
/admin/help_files/helpfile/<path:object_id>/	django.views.generic.base.RedirectView
/admin/help_files/helpfile/<path:object_id>/change/	tendenci.apps.perms.admin.change_view	admin:help_files_helpfile_change
/admin/help_files/helpfile/<path:object_id>/delete/	django.contrib.admin.options.delete_view	admin:help_files_helpfile_delete
/admin/help_files/helpfile/<path:object_id>/history/	django.contrib.admin.options.history_view	admin:help_files_helpfile_history
/admin/help_files/helpfile/add/	django.contrib.admin.options.add_view	admin:help_files_helpfile_add
/admin/help_files/helpfile/autocomplete/	django.contrib.admin.options.autocomplete_view	admin:help_files_helpfile_autocomplete
/admin/help_files/request/	django.contrib.admin.options.changelist_view	admin:help_files_request_changelist
/admin/help_files/request/<path:object_id>/	django.views.generic.base.RedirectView
/admin/help_files/request/<path:object_id>/change/	django.contrib.admin.options.change_view	admin:help_files_request_change
/admin/help_files/request/<path:object_id>/delete/	django.contrib.admin.options.delete_view	admin:help_files_request_delete
/admin/help_files/request/<path:object_id>/history/	django.contrib.admin.options.history_view	admin:help_files_request_history
/admin/help_files/request/add/	django.contrib.admin.options.add_view	admin:help_files_request_add
/admin/help_files/request/autocomplete/	django.contrib.admin.options.autocomplete_view	admin:help_files_request_autocomplete
/admin/help_files/topic/	django.contrib.admin.options.changelist_view	admin:help_files_topic_changelist
/admin/help_files/topic/<path:object_id>/	django.views.generic.base.RedirectView
/admin/help_files/topic/<path:object_id>/change/	django.contrib.admin.options.change_view	admin:help_files_topic_change
/admin/help_files/topic/<path:object_id>/delete/	django.contrib.admin.options.delete_view	admin:help_files_topic_delete
/admin/help_files/topic/<path:object_id>/history/	django.contrib.admin.options.history_view	admin:help_files_topic_history
/admin/help_files/topic/add/	django.contrib.admin.options.add_view	admin:help_files_topic_add
/admin/help_files/topic/autocomplete/	django.contrib.admin.options.autocomplete_view	admin:help_files_topic_autocomplete
/admin/httpproxy/request/	django.contrib.admin.options.changelist_view	admin:httpproxy_request_changelist
/admin/httpproxy/request/<path:object_id>/	django.views.generic.base.RedirectView
/admin/httpproxy/request/<path:object_id>/change/	django.contrib.admin.options.change_view	admin:httpproxy_request_change
/admin/httpproxy/request/<path:object_id>/delete/	django.contrib.admin.options.delete_view	admin:httpproxy_request_delete
/admin/httpproxy/request/<path:object_id>/history/	django.contrib.admin.options.history_view	admin:httpproxy_request_history
/admin/httpproxy/request/add/	django.contrib.admin.options.add_view	admin:httpproxy_request_add
/admin/httpproxy/request/autocomplete/	django.contrib.admin.options.autocomplete_view	admin:httpproxy_request_autocomplete
/admin/httpproxy/response/	django.contrib.admin.options.changelist_view	admin:httpproxy_response_changelist
/admin/httpproxy/response/<path:object_id>/	django.views.generic.base.RedirectView
/admin/httpproxy/response/<path:object_id>/change/	django.contrib.admin.options.change_view	admin:httpproxy_response_change
/admin/httpproxy/response/<path:object_id>/delete/	django.contrib.admin.options.delete_view	admin:httpproxy_response_delete
/admin/httpproxy/response/<path:object_id>/history/	django.contrib.admin.options.history_view	admin:httpproxy_response_history
/admin/httpproxy/response/add/	django.contrib.admin.options.add_view	admin:httpproxy_response_add
/admin/httpproxy/response/autocomplete/	django.contrib.admin.options.autocomplete_view	admin:httpproxy_response_autocomplete
/admin/industries/industry/	django.contrib.admin.options.changelist_view	admin:industries_industry_changelist
/admin/industries/industry/<path:object_id>/	django.views.generic.base.RedirectView
/admin/industries/industry/<path:object_id>/change/	tendenci.apps.perms.admin.change_view	admin:industries_industry_change
/admin/industries/industry/<path:object_id>/delete/	django.contrib.admin.options.delete_view	admin:industries_industry_delete
/admin/industries/industry/<path:object_id>/history/	django.contrib.admin.options.history_view	admin:industries_industry_history
/admin/industries/industry/add/	django.contrib.admin.options.add_view	admin:industries_industry_add
/admin/industries/industry/autocomplete/	django.contrib.admin.options.autocomplete_view	admin:industries_industry_autocomplete
/admin/jobs/category/	django.contrib.admin.options.changelist_view	admin:jobs_category_changelist
/admin/jobs/category/<path:object_id>/	django.views.generic.base.RedirectView
/admin/jobs/category/<path:object_id>/change/	django.contrib.admin.options.change_view	admin:jobs_category_change
/admin/jobs/category/<path:object_id>/delete/	django.contrib.admin.options.delete_view	admin:jobs_category_delete
/admin/jobs/category/<path:object_id>/history/	django.contrib.admin.options.history_view	admin:jobs_category_history
/admin/jobs/category/add/	django.contrib.admin.options.add_view	admin:jobs_category_add
/admin/jobs/category/autocomplete/	django.contrib.admin.options.autocomplete_view	admin:jobs_category_autocomplete
/admin/jobs/job/	django.contrib.admin.options.changelist_view	admin:jobs_job_changelist
/admin/jobs/job/<path:object_id>/	django.views.generic.base.RedirectView
/admin/jobs/job/<path:object_id>/change/	tendenci.apps.perms.admin.change_view	admin:jobs_job_change
/admin/jobs/job/<path:object_id>/delete/	django.contrib.admin.options.delete_view	admin:jobs_job_delete
/admin/jobs/job/<path:object_id>/history/	django.contrib.admin.options.history_view	admin:jobs_job_history
/admin/jobs/job/add/	django.contrib.admin.options.add_view	admin:jobs_job_add
/admin/jobs/job/autocomplete/	django.contrib.admin.options.autocomplete_view	admin:jobs_job_autocomplete
/admin/jobs/jobpricing/	django.contrib.admin.options.changelist_view	admin:jobs_jobpricing_changelist
/admin/jobs/jobpricing/<path:object_id>/	django.views.generic.base.RedirectView
/admin/jobs/jobpricing/<path:object_id>/change/	django.contrib.admin.options.change_view	admin:jobs_jobpricing_change
/admin/jobs/jobpricing/<path:object_id>/delete/	django.contrib.admin.options.delete_view	admin:jobs_jobpricing_delete
/admin/jobs/jobpricing/<path:object_id>/history/	django.contrib.admin.options.history_view	admin:jobs_jobpricing_history
/admin/jobs/jobpricing/add/	django.contrib.admin.options.add_view	admin:jobs_jobpricing_add
/admin/jobs/jobpricing/autocomplete/	django.contrib.admin.options.autocomplete_view	admin:jobs_jobpricing_autocomplete
/admin/jsi18n/	django.contrib.admin.sites.i18n_javascript	admin:jsi18n
/admin/locations/location/	django.contrib.admin.options.changelist_view	admin:locations_location_changelist
/admin/locations/location/<path:object_id>/	django.views.generic.base.RedirectView
/admin/locations/location/<path:object_id>/change/	tendenci.apps.perms.admin.change_view	admin:locations_location_change
/admin/locations/location/<path:object_id>/delete/	django.contrib.admin.options.delete_view	admin:locations_location_delete
/admin/locations/location/<path:object_id>/history/	django.contrib.admin.options.history_view	admin:locations_location_history
/admin/locations/location/add/	django.contrib.admin.options.add_view	admin:locations_location_add
/admin/locations/location/autocomplete/	django.contrib.admin.options.autocomplete_view	admin:locations_location_autocomplete
/admin/login/	django.contrib.admin.sites.login	admin:login
/admin/logout/	django.contrib.admin.sites.logout	admin:logout
/admin/memberships/membershipapp/	django.contrib.admin.options.changelist_view	admin:memberships_membershipapp_changelist
/admin/memberships/membershipapp/<path:object_id>/	django.views.generic.base.RedirectView
/admin/memberships/membershipapp/<path:object_id>/change/	django.contrib.admin.options.change_view	admin:memberships_membershipapp_change
/admin/memberships/membershipapp/<path:object_id>/delete/	django.contrib.admin.options.delete_view	admin:memberships_membershipapp_delete
/admin/memberships/membershipapp/<path:object_id>/history/	django.contrib.admin.options.history_view	admin:memberships_membershipapp_history
/admin/memberships/membershipapp/add/	django.contrib.admin.options.add_view	admin:memberships_membershipapp_add
/admin/memberships/membershipapp/autocomplete/	django.contrib.admin.options.autocomplete_view	admin:memberships_membershipapp_autocomplete
/admin/memberships/membershipappfield/	django.contrib.admin.options.changelist_view	admin:memberships_membershipappfield_changelist
/admin/memberships/membershipappfield/<path:object_id>/	django.views.generic.base.RedirectView
/admin/memberships/membershipappfield/<path:object_id>/change/	django.contrib.admin.options.change_view	admin:memberships_membershipappfield_change
/admin/memberships/membershipappfield/<path:object_id>/delete/	django.contrib.admin.options.delete_view	admin:memberships_membershipappfield_delete
/admin/memberships/membershipappfield/<path:object_id>/history/	django.contrib.admin.options.history_view	admin:memberships_membershipappfield_history
/admin/memberships/membershipappfield/add/	django.contrib.admin.options.add_view	admin:memberships_membershipappfield_add
/admin/memberships/membershipappfield/autocomplete/	django.contrib.admin.options.autocomplete_view	admin:memberships_membershipappfield_autocomplete
/admin/memberships/membershipdefault/	django.contrib.admin.options.changelist_view	admin:memberships_membershipdefault_changelist
/admin/memberships/membershipdefault/<path:object_id>/	django.views.generic.base.RedirectView
/admin/memberships/membershipdefault/<path:object_id>/change/	django.contrib.admin.options.change_view	admin:memberships_membershipdefault_change
/admin/memberships/membershipdefault/<path:object_id>/delete/	django.contrib.admin.options.delete_view	admin:memberships_membershipdefault_delete
/admin/memberships/membershipdefault/<path:object_id>/history/	django.contrib.admin.options.history_view	admin:memberships_membershipdefault_history
/admin/memberships/membershipdefault/add/	tendenci.apps.memberships.admin.add_view	admin:memberships_membershipdefault_add
/admin/memberships/membershipdefault/approve/<pk>/	tendenci.apps.memberships.admin.approve	admin:membership.admin_approve
/admin/memberships/membershipdefault/autocomplete/	django.contrib.admin.options.autocomplete_view	admin:memberships_membershipdefault_autocomplete
/admin/memberships/membershipdefault/disapprove/<pk>/	tendenci.apps.memberships.admin.disapprove	admin:membership.admin_disapprove
/admin/memberships/membershipdefault/expire/<pk>/	tendenci.apps.memberships.admin.expire	admin:membership.admin_expire
/admin/memberships/membershipdefault/renew/<pk>/	tendenci.apps.memberships.admin.renew	admin:membership.admin_renew
/admin/memberships/membershiptype/	django.contrib.admin.options.changelist_view	admin:memberships_membershiptype_changelist
/admin/memberships/membershiptype/<path:object_id>/	django.views.generic.base.RedirectView
/admin/memberships/membershiptype/<path:object_id>/change/	tendenci.apps.perms.admin.change_view	admin:memberships_membershiptype_change
/admin/memberships/membershiptype/<path:object_id>/delete/	django.contrib.admin.options.delete_view	admin:memberships_membershiptype_delete
/admin/memberships/membershiptype/<path:object_id>/history/	django.contrib.admin.options.history_view	admin:memberships_membershiptype_history
/admin/memberships/membershiptype/add/	tendenci.apps.memberships.admin.add_view	admin:memberships_membershiptype_add
/admin/memberships/membershiptype/autocomplete/	django.contrib.admin.options.autocomplete_view	admin:memberships_membershiptype_autocomplete
/admin/memberships/notice/	django.contrib.admin.options.changelist_view	admin:memberships_notice_changelist
/admin/memberships/notice/<path:object_id>/	django.views.generic.base.RedirectView
/admin/memberships/notice/<path:object_id>/change/	django.contrib.admin.options.change_view	admin:memberships_notice_change
/admin/memberships/notice/<path:object_id>/delete/	django.contrib.admin.options.delete_view	admin:memberships_notice_delete
/admin/memberships/notice/<path:object_id>/history/	django.contrib.admin.options.history_view	admin:memberships_notice_history
/admin/memberships/notice/add/	django.contrib.admin.options.add_view	admin:memberships_notice_add
/admin/memberships/notice/autocomplete/	django.contrib.admin.options.autocomplete_view	admin:memberships_notice_autocomplete
/admin/memberships/notice/clone/<pk>/	tendenci.apps.memberships.admin.clone	admin:membership_notice.admin_clone
/admin/navs/nav/	django.contrib.admin.options.changelist_view	admin:navs_nav_changelist
/admin/navs/nav/<path:object_id>/	django.views.generic.base.RedirectView
/admin/navs/nav/<path:object_id>/change/	tendenci.apps.perms.admin.change_view	admin:navs_nav_change
/admin/navs/nav/<path:object_id>/delete/	django.contrib.admin.options.delete_view	admin:navs_nav_delete
/admin/navs/nav/<path:object_id>/history/	django.contrib.admin.options.history_view	admin:navs_nav_history
/admin/navs/nav/add/	django.contrib.admin.options.add_view	admin:navs_nav_add
/admin/navs/nav/autocomplete/	django.contrib.admin.options.autocomplete_view	admin:navs_nav_autocomplete
/admin/news/news/	django.contrib.admin.options.changelist_view	admin:news_news_changelist
/admin/news/news/<path:object_id>/	django.views.generic.base.RedirectView
/admin/news/news/<path:object_id>/change/	tendenci.apps.perms.admin.change_view	admin:news_news_change
/admin/news/news/<path:object_id>/delete/	django.contrib.admin.options.delete_view	admin:news_news_delete
/admin/news/news/<path:object_id>/history/	django.contrib.admin.options.history_view	admin:news_news_history
/admin/news/news/add/	django.contrib.admin.options.add_view	admin:news_news_add
/admin/news/news/autocomplete/	django.contrib.admin.options.autocomplete_view	admin:news_news_autocomplete
/admin/newsletters/newsletter/	django.contrib.admin.options.changelist_view	admin:newsletters_newsletter_changelist
/admin/newsletters/newsletter/<path:object_id>/	django.views.generic.base.RedirectView
/admin/newsletters/newsletter/<path:object_id>/change/	tendenci.apps.perms.admin.change_view	admin:newsletters_newsletter_change
/admin/newsletters/newsletter/<path:object_id>/delete/	django.contrib.admin.options.delete_view	admin:newsletters_newsletter_delete
/admin/newsletters/newsletter/<path:object_id>/history/	django.contrib.admin.options.history_view	admin:newsletters_newsletter_history
/admin/newsletters/newsletter/add/	django.contrib.admin.options.add_view	admin:newsletters_newsletter_add
/admin/newsletters/newsletter/autocomplete/	django.contrib.admin.options.autocomplete_view	admin:newsletters_newsletter_autocomplete
/admin/newsletters/newslettertemplate/	django.contrib.admin.options.changelist_view	admin:newsletters_newslettertemplate_changelist
/admin/newsletters/newslettertemplate/<path:object_id>/	django.views.generic.base.RedirectView
/admin/newsletters/newslettertemplate/<path:object_id>/change/	django.contrib.admin.options.change_view	admin:newsletters_newslettertemplate_change
/admin/newsletters/newslettertemplate/<path:object_id>/delete/	django.contrib.admin.options.delete_view	admin:newsletters_newslettertemplate_delete
/admin/newsletters/newslettertemplate/<path:object_id>/history/	django.contrib.admin.options.history_view	admin:newsletters_newslettertemplate_history
/admin/newsletters/newslettertemplate/add/	django.contrib.admin.options.add_view	admin:newsletters_newslettertemplate_add
/admin/newsletters/newslettertemplate/autocomplete/	django.contrib.admin.options.autocomplete_view	admin:newsletters_newslettertemplate_autocomplete
/admin/notifications/noticeemail/	django.contrib.admin.options.changelist_view	admin:notifications_noticeemail_changelist
/admin/notifications/noticeemail/<path:object_id>/	django.views.generic.base.RedirectView
/admin/notifications/noticeemail/<path:object_id>/change/	django.contrib.admin.options.change_view	admin:notifications_noticeemail_change
/admin/notifications/noticeemail/<path:object_id>/delete/	django.contrib.admin.options.delete_view	admin:notifications_noticeemail_delete
/admin/notifications/noticeemail/<path:object_id>/history/	django.contrib.admin.options.history_view	admin:notifications_noticeemail_history
/admin/notifications/noticeemail/add/	django.contrib.admin.options.add_view	admin:notifications_noticeemail_add
/admin/notifications/noticeemail/autocomplete/	django.contrib.admin.options.autocomplete_view	admin:notifications_noticeemail_autocomplete
/admin/pages/page/	django.contrib.admin.options.changelist_view	admin:pages_page_changelist
/admin/pages/page/<path:object_id>/	django.views.generic.base.RedirectView
/admin/pages/page/<path:object_id>/change/	django.contrib.admin.options.change_view	admin:pages_page_change
/admin/pages/page/<path:object_id>/delete/	django.contrib.admin.options.delete_view	admin:pages_page_delete
/admin/pages/page/<path:object_id>/history/	django.contrib.admin.options.history_view	admin:pages_page_history
/admin/pages/page/add/	django.contrib.admin.options.add_view	admin:pages_page_add
/admin/pages/page/autocomplete/	django.contrib.admin.options.autocomplete_view	admin:pages_page_autocomplete
/admin/password_change/	django.contrib.admin.sites.password_change	admin:password_change
/admin/password_change/done/	django.contrib.admin.sites.password_change_done	admin:password_change_done
/admin/payments/payment/	django.contrib.admin.options.changelist_view	admin:payments_payment_changelist
/admin/payments/payment/<path:object_id>/	django.views.generic.base.RedirectView
/admin/payments/payment/<path:object_id>/change/	django.contrib.admin.options.change_view	admin:payments_payment_change
/admin/payments/payment/<path:object_id>/delete/	django.contrib.admin.options.delete_view	admin:payments_payment_delete
/admin/payments/payment/<path:object_id>/history/	django.contrib.admin.options.history_view	admin:payments_payment_history
/admin/payments/payment/add/	django.contrib.admin.options.add_view	admin:payments_payment_add
/admin/payments/payment/autocomplete/	django.contrib.admin.options.autocomplete_view	admin:payments_payment_autocomplete
/admin/payments/paymentmethod/	django.contrib.admin.options.changelist_view	admin:payments_paymentmethod_changelist
/admin/payments/paymentmethod/<path:object_id>/	django.views.generic.base.RedirectView
/admin/payments/paymentmethod/<path:object_id>/change/	django.contrib.admin.options.change_view	admin:payments_paymentmethod_change
/admin/payments/paymentmethod/<path:object_id>/delete/	django.contrib.admin.options.delete_view	admin:payments_paymentmethod_delete
/admin/payments/paymentmethod/<path:object_id>/history/	django.contrib.admin.options.history_view	admin:payments_paymentmethod_history
/admin/payments/paymentmethod/add/	django.contrib.admin.options.add_view	admin:payments_paymentmethod_add
/admin/payments/paymentmethod/autocomplete/	django.contrib.admin.options.autocomplete_view	admin:payments_paymentmethod_autocomplete
/admin/photos/photoset/	django.contrib.admin.options.changelist_view	admin:photos_photoset_changelist
/admin/photos/photoset/<path:object_id>/	django.views.generic.base.RedirectView
/admin/photos/photoset/<path:object_id>/change/	django.contrib.admin.options.change_view	admin:photos_photoset_change
/admin/photos/photoset/<path:object_id>/delete/	django.contrib.admin.options.delete_view	admin:photos_photoset_delete
/admin/photos/photoset/<path:object_id>/history/	django.contrib.admin.options.history_view	admin:photos_photoset_history
/admin/photos/photoset/add/	django.contrib.admin.options.add_view	admin:photos_photoset_add
/admin/photos/photoset/autocomplete/	django.contrib.admin.options.autocomplete_view	admin:photos_photoset_autocomplete
/admin/profiles/profile/	django.contrib.admin.options.changelist_view	admin:profiles_profile_changelist
/admin/profiles/profile/<path:object_id>/	django.views.generic.base.RedirectView
/admin/profiles/profile/<path:object_id>/change/	tendenci.apps.perms.admin.change_view	admin:profiles_profile_change
/admin/profiles/profile/<path:object_id>/delete/	django.contrib.admin.options.delete_view	admin:profiles_profile_delete
/admin/profiles/profile/<path:object_id>/history/	django.contrib.admin.options.history_view	admin:profiles_profile_history
/admin/profiles/profile/add/	django.contrib.admin.options.add_view	admin:profiles_profile_add
/admin/profiles/profile/autocomplete/	django.contrib.admin.options.autocomplete_view	admin:profiles_profile_autocomplete
/admin/r/<int:content_type_id>/<path:object_id>/	django.contrib.contenttypes.views.shortcut	admin:view_on_site
/admin/redirects/redirect/	django.contrib.admin.options.changelist_view	admin:redirects_redirect_changelist
/admin/redirects/redirect/<path:object_id>/	django.views.generic.base.RedirectView
/admin/redirects/redirect/<path:object_id>/change/	tendenci.apps.perms.admin.change_view	admin:redirects_redirect_change
/admin/redirects/redirect/<path:object_id>/delete/	django.contrib.admin.options.delete_view	admin:redirects_redirect_delete
/admin/redirects/redirect/<path:object_id>/history/	django.contrib.admin.options.history_view	admin:redirects_redirect_history
/admin/redirects/redirect/add/	django.contrib.admin.options.add_view	admin:redirects_redirect_add
/admin/redirects/redirect/autocomplete/	django.contrib.admin.options.autocomplete_view	admin:redirects_redirect_autocomplete
/admin/regions/region/	django.contrib.admin.options.changelist_view	admin:regions_region_changelist
/admin/regions/region/<path:object_id>/	django.views.generic.base.RedirectView
/admin/regions/region/<path:object_id>/change/	tendenci.apps.perms.admin.change_view	admin:regions_region_change
/admin/regions/region/<path:object_id>/delete/	django.contrib.admin.options.delete_view	admin:regions_region_delete
/admin/regions/region/<path:object_id>/history/	django.contrib.admin.options.history_view	admin:regions_region_history
/admin/regions/region/add/	django.contrib.admin.options.add_view	admin:regions_region_add
/admin/regions/region/autocomplete/	django.contrib.admin.options.autocomplete_view	admin:regions_region_autocomplete
/admin/registration/registrationprofile/	django.contrib.admin.options.changelist_view	admin:registration_registrationprofile_changelist
/admin/registration/registrationprofile/<path:object_id>/	django.views.generic.base.RedirectView
/admin/registration/registrationprofile/<path:object_id>/change/	django.contrib.admin.options.change_view	admin:registration_registrationprofile_change
/admin/registration/registrationprofile/<path:object_id>/delete/	django.contrib.admin.options.delete_view	admin:registration_registrationprofile_delete
/admin/registration/registrationprofile/<path:object_id>/history/	django.contrib.admin.options.history_view	admin:registration_registrationprofile_history
/admin/registration/registrationprofile/add/	django.contrib.admin.options.add_view	admin:registration_registrationprofile_add
/admin/registration/registrationprofile/autocomplete/	django.contrib.admin.options.autocomplete_view	admin:registration_registrationprofile_autocomplete
/admin/site_settings/setting/	django.contrib.admin.options.changelist_view	admin:site_settings_setting_changelist
/admin/site_settings/setting/<path:object_id>/	django.views.generic.base.RedirectView
/admin/site_settings/setting/<path:object_id>/change/	django.contrib.admin.options.change_view	admin:site_settings_setting_change
/admin/site_settings/setting/<path:object_id>/delete/	django.contrib.admin.options.delete_view	admin:site_settings_setting_delete
/admin/site_settings/setting/<path:object_id>/history/	django.contrib.admin.options.history_view	admin:site_settings_setting_history
/admin/site_settings/setting/add/	django.contrib.admin.options.add_view	admin:site_settings_setting_add
/admin/site_settings/setting/autocomplete/	django.contrib.admin.options.autocomplete_view	admin:site_settings_setting_autocomplete
/admin/sites/site/	django.contrib.admin.options.changelist_view	admin:sites_site_changelist
/admin/sites/site/<path:object_id>/	django.views.generic.base.RedirectView
/admin/sites/site/<path:object_id>/change/	django.contrib.admin.options.change_view	admin:sites_site_change
/admin/sites/site/<path:object_id>/delete/	django.contrib.admin.options.delete_view	admin:sites_site_delete
/admin/sites/site/<path:object_id>/history/	django.contrib.admin.options.history_view	admin:sites_site_history
/admin/sites/site/add/	django.contrib.admin.options.add_view	admin:sites_site_add
/admin/sites/site/autocomplete/	django.contrib.admin.options.autocomplete_view	admin:sites_site_autocomplete
/admin/staff/department/	django.contrib.admin.options.changelist_view	admin:staff_department_changelist
/admin/staff/department/<path:object_id>/	django.views.generic.base.RedirectView
/admin/staff/department/<path:object_id>/change/	django.contrib.admin.options.change_view	admin:staff_department_change
/admin/staff/department/<path:object_id>/delete/	django.contrib.admin.options.delete_view	admin:staff_department_delete
/admin/staff/department/<path:object_id>/history/	django.contrib.admin.options.history_view	admin:staff_department_history
/admin/staff/department/add/	django.contrib.admin.options.add_view	admin:staff_department_add
/admin/staff/department/autocomplete/	django.contrib.admin.options.autocomplete_view	admin:staff_department_autocomplete
/admin/staff/position/	django.contrib.admin.options.changelist_view	admin:staff_position_changelist
/admin/staff/position/<path:object_id>/	django.views.generic.base.RedirectView
/admin/staff/position/<path:object_id>/change/	django.contrib.admin.options.change_view	admin:staff_position_change
/admin/staff/position/<path:object_id>/delete/	django.contrib.admin.options.delete_view	admin:staff_position_delete
/admin/staff/position/<path:object_id>/history/	django.contrib.admin.options.history_view	admin:staff_position_history
/admin/staff/position/add/	django.contrib.admin.options.add_view	admin:staff_position_add
/admin/staff/position/autocomplete/	django.contrib.admin.options.autocomplete_view	admin:staff_position_autocomplete
/admin/staff/staff/	django.contrib.admin.options.changelist_view	admin:staff_staff_changelist
/admin/staff/staff/<path:object_id>/	django.views.generic.base.RedirectView
/admin/staff/staff/<path:object_id>/change/	tendenci.apps.perms.admin.change_view	admin:staff_staff_change
/admin/staff/staff/<path:object_id>/delete/	django.contrib.admin.options.delete_view	admin:staff_staff_delete
/admin/staff/staff/<path:object_id>/history/	django.contrib.admin.options.history_view	admin:staff_staff_history
/admin/staff/staff/add/	django.contrib.admin.options.add_view	admin:staff_staff_add
/admin/staff/staff/autocomplete/	django.contrib.admin.options.autocomplete_view	admin:staff_staff_autocomplete
/admin/stories/rotator/	django.contrib.admin.options.changelist_view	admin:stories_rotator_changelist
/admin/stories/rotator/<path:object_id>/	django.views.generic.base.RedirectView
/admin/stories/rotator/<path:object_id>/change/	django.contrib.admin.options.change_view	admin:stories_rotator_change
/admin/stories/rotator/<path:object_id>/delete/	django.contrib.admin.options.delete_view	admin:stories_rotator_delete
/admin/stories/rotator/<path:object_id>/history/	django.contrib.admin.options.history_view	admin:stories_rotator_history
/admin/stories/rotator/add/	django.contrib.admin.options.add_view	admin:stories_rotator_add
/admin/stories/rotator/autocomplete/	django.contrib.admin.options.autocomplete_view	admin:stories_rotator_autocomplete
/admin/stories/story/	django.contrib.admin.options.changelist_view	admin:stories_story_changelist
/admin/stories/story/<path:object_id>/	django.views.generic.base.RedirectView
/admin/stories/story/<path:object_id>/change/	tendenci.apps.perms.admin.change_view	admin:stories_story_change
/admin/stories/story/<path:object_id>/delete/	django.contrib.admin.options.delete_view	admin:stories_story_delete
/admin/stories/story/<path:object_id>/history/	django.contrib.admin.options.history_view	admin:stories_story_history
/admin/stories/story/add/	django.contrib.admin.options.add_view	admin:stories_story_add
/admin/stories/story/autocomplete/	django.contrib.admin.options.autocomplete_view	admin:stories_story_autocomplete
/admin/stripe/charge/	django.contrib.admin.options.changelist_view	admin:stripe_charge_changelist
/admin/stripe/charge/<path:object_id>/	django.views.generic.base.RedirectView
/admin/stripe/charge/<path:object_id>/change/	tendenci.apps.payments.stripe.admin.change_view	admin:stripe_charge_change
/admin/stripe/charge/<path:object_id>/delete/	django.contrib.admin.options.delete_view	admin:stripe_charge_delete
/admin/stripe/charge/<path:object_id>/history/	django.contrib.admin.options.history_view	admin:stripe_charge_history
/admin/stripe/charge/add/	django.contrib.admin.options.add_view	admin:stripe_charge_add
/admin/stripe/charge/autocomplete/	django.contrib.admin.options.autocomplete_view	admin:stripe_charge_autocomplete
/admin/stripe/stripeaccount/	django.contrib.admin.options.changelist_view	admin:stripe_stripeaccount_changelist
/admin/stripe/stripeaccount/<path:object_id>/	django.views.generic.base.RedirectView
/admin/stripe/stripeaccount/<path:object_id>/change/	tendenci.apps.perms.admin.change_view	admin:stripe_stripeaccount_change
/admin/stripe/stripeaccount/<path:object_id>/delete/	django.contrib.admin.options.delete_view	admin:stripe_stripeaccount_delete
/admin/stripe/stripeaccount/<path:object_id>/history/	django.contrib.admin.options.history_view	admin:stripe_stripeaccount_history
/admin/stripe/stripeaccount/add/	tendenci.apps.payments.stripe.admin.add_view	admin:stripe_stripeaccount_add
/admin/stripe/stripeaccount/autocomplete/	django.contrib.admin.options.autocomplete_view	admin:stripe_stripeaccount_autocomplete
/admin/studygroups/position/	django.contrib.admin.options.changelist_view	admin:studygroups_position_changelist
/admin/studygroups/position/<path:object_id>/	django.views.generic.base.RedirectView
/admin/studygroups/position/<path:object_id>/change/	django.contrib.admin.options.change_view	admin:studygroups_position_change
/admin/studygroups/position/<path:object_id>/delete/	django.contrib.admin.options.delete_view	admin:studygroups_position_delete
/admin/studygroups/position/<path:object_id>/history/	django.contrib.admin.options.history_view	admin:studygroups_position_history
/admin/studygroups/position/add/	django.contrib.admin.options.add_view	admin:studygroups_position_add
/admin/studygroups/position/autocomplete/	django.contrib.admin.options.autocomplete_view	admin:studygroups_position_autocomplete
/admin/studygroups/studygroup/	django.contrib.admin.options.changelist_view	admin:studygroups_studygroup_changelist
/admin/studygroups/studygroup/<path:object_id>/	django.views.generic.base.RedirectView
/admin/studygroups/studygroup/<path:object_id>/change/	tendenci.apps.perms.admin.change_view	admin:studygroups_studygroup_change
/admin/studygroups/studygroup/<path:object_id>/delete/	django.contrib.admin.options.delete_view	admin:studygroups_studygroup_delete
/admin/studygroups/studygroup/<path:object_id>/history/	django.contrib.admin.options.history_view	admin:studygroups_studygroup_history
/admin/studygroups/studygroup/add/	django.contrib.admin.options.add_view	admin:studygroups_studygroup_add
/admin/studygroups/studygroup/autocomplete/	django.contrib.admin.options.autocomplete_view	admin:studygroups_studygroup_autocomplete
/admin/tagging/tag/	django.contrib.admin.options.changelist_view	admin:tagging_tag_changelist
/admin/tagging/tag/<path:object_id>/	django.views.generic.base.RedirectView
/admin/tagging/tag/<path:object_id>/change/	django.contrib.admin.options.change_view	admin:tagging_tag_change
/admin/tagging/tag/<path:object_id>/delete/	django.contrib.admin.options.delete_view	admin:tagging_tag_delete
/admin/tagging/tag/<path:object_id>/history/	django.contrib.admin.options.history_view	admin:tagging_tag_history
/admin/tagging/tag/add/	django.contrib.admin.options.add_view	admin:tagging_tag_add
/admin/tagging/tag/autocomplete/	django.contrib.admin.options.autocomplete_view	admin:tagging_tag_autocomplete
/admin/tagging/taggeditem/	django.contrib.admin.options.changelist_view	admin:tagging_taggeditem_changelist
/admin/tagging/taggeditem/<path:object_id>/	django.views.generic.base.RedirectView
/admin/tagging/taggeditem/<path:object_id>/change/	django.contrib.admin.options.change_view	admin:tagging_taggeditem_change
/admin/tagging/taggeditem/<path:object_id>/delete/	django.contrib.admin.options.delete_view	admin:tagging_taggeditem_delete
/admin/tagging/taggeditem/<path:object_id>/history/	django.contrib.admin.options.history_view	admin:tagging_taggeditem_history
/admin/tagging/taggeditem/add/	django.contrib.admin.options.add_view	admin:tagging_taggeditem_add
/admin/tagging/taggeditem/autocomplete/	django.contrib.admin.options.autocomplete_view	admin:tagging_taggeditem_autocomplete
/admin/tastypie/apikey/	django.contrib.admin.options.changelist_view	admin:tastypie_apikey_changelist
/admin/tastypie/apikey/<path:object_id>/	django.views.generic.base.RedirectView
/admin/tastypie/apikey/<path:object_id>/change/	django.contrib.admin.options.change_view	admin:tastypie_apikey_change
/admin/tastypie/apikey/<path:object_id>/delete/	django.contrib.admin.options.delete_view	admin:tastypie_apikey_delete
/admin/tastypie/apikey/<path:object_id>/history/	django.contrib.admin.options.history_view	admin:tastypie_apikey_history
/admin/tastypie/apikey/add/	django.contrib.admin.options.add_view	admin:tastypie_apikey_add
/admin/tastypie/apikey/autocomplete/	django.contrib.admin.options.autocomplete_view	admin:tastypie_apikey_autocomplete
/admin/testimonials/testimonial/	django.contrib.admin.options.changelist_view	admin:testimonials_testimonial_changelist
/admin/testimonials/testimonial/<path:object_id>/	django.views.generic.base.RedirectView
/admin/testimonials/testimonial/<path:object_id>/change/	tendenci.apps.perms.admin.change_view	admin:testimonials_testimonial_change
/admin/testimonials/testimonial/<path:object_id>/delete/	django.contrib.admin.options.delete_view	admin:testimonials_testimonial_delete
/admin/testimonials/testimonial/<path:object_id>/history/	django.contrib.admin.options.history_view	admin:testimonials_testimonial_history
/admin/testimonials/testimonial/add/	django.contrib.admin.options.add_view	admin:testimonials_testimonial_add
/admin/testimonials/testimonial/autocomplete/	django.contrib.admin.options.autocomplete_view	admin:testimonials_testimonial_autocomplete
/admin/user_groups/group/	django.contrib.admin.options.changelist_view	admin:user_groups_group_changelist
/admin/user_groups/group/<path:object_id>/	django.views.generic.base.RedirectView
/admin/user_groups/group/<path:object_id>/change/	tendenci.apps.perms.admin.change_view	admin:user_groups_group_change
/admin/user_groups/group/<path:object_id>/delete/	django.contrib.admin.options.delete_view	admin:user_groups_group_delete
/admin/user_groups/group/<path:object_id>/history/	django.contrib.admin.options.history_view	admin:user_groups_group_history
/admin/user_groups/group/add/	django.contrib.admin.options.add_view	admin:user_groups_group_add
/admin/user_groups/group/autocomplete/	django.contrib.admin.options.autocomplete_view	admin:user_groups_group_autocomplete
/api_tasty/<api_name>/	tastypie.api.wrapper	api_v1_top_level
/api_tasty/<api_name>/<resource_name>/	tastypie.resources.wrapper	api_dispatch_list
/api_tasty/<api_name>/<resource_name>/	tastypie.resources.wrapper	api_dispatch_list
/api_tasty/<api_name>/<resource_name>/	tastypie.resources.wrapper	api_dispatch_list
/api_tasty/<api_name>/<resource_name>/	tastypie.resources.wrapper	api_dispatch_list
/api_tasty/<api_name>/<resource_name>/	tastypie.resources.wrapper	api_dispatch_list
/api_tasty/<api_name>/<resource_name>/	tastypie.resources.wrapper	api_dispatch_list
/api_tasty/<api_name>/<resource_name>/	tastypie.resources.wrapper	api_dispatch_list
/api_tasty/<api_name>/<resource_name>/	tastypie.resources.wrapper	api_dispatch_list
/api_tasty/<api_name>/<resource_name>/	tastypie.resources.wrapper	api_dispatch_list
/api_tasty/<api_name>/<resource_name>/	tastypie.resources.wrapper	api_dispatch_list
/api_tasty/<api_name>/<resource_name>/	tastypie.resources.wrapper	api_dispatch_list
/api_tasty/<api_name>/<resource_name>/	tastypie.resources.wrapper	api_dispatch_list
/api_tasty/<api_name>/<resource_name>/<pk>/	tastypie.resources.wrapper	api_dispatch_detail
/api_tasty/<api_name>/<resource_name>/<pk>/	tastypie.resources.wrapper	api_dispatch_detail
/api_tasty/<api_name>/<resource_name>/<pk>/	tastypie.resources.wrapper	api_dispatch_detail
/api_tasty/<api_name>/<resource_name>/<pk>/	tastypie.resources.wrapper	api_dispatch_detail
/api_tasty/<api_name>/<resource_name>/<pk>/	tastypie.resources.wrapper	api_dispatch_detail
/api_tasty/<api_name>/<resource_name>/<pk>/	tastypie.resources.wrapper	api_dispatch_detail
/api_tasty/<api_name>/<resource_name>/<pk>/	tastypie.resources.wrapper	api_dispatch_detail
/api_tasty/<api_name>/<resource_name>/<pk>/	tastypie.resources.wrapper	api_dispatch_detail
/api_tasty/<api_name>/<resource_name>/<pk>/	tastypie.resources.wrapper	api_dispatch_detail
/api_tasty/<api_name>/<resource_name>/<pk>/	tastypie.resources.wrapper	api_dispatch_detail
/api_tasty/<api_name>/<resource_name>/<pk>/	tastypie.resources.wrapper	api_dispatch_detail
/api_tasty/<api_name>/<resource_name>/<pk>/	tastypie.resources.wrapper	api_dispatch_detail
/api_tasty/<api_name>/<resource_name>/schema/	tastypie.resources.wrapper	api_get_schema
/api_tasty/<api_name>/<resource_name>/schema/	tastypie.resources.wrapper	api_get_schema
/api_tasty/<api_name>/<resource_name>/schema/	tastypie.resources.wrapper	api_get_schema
/api_tasty/<api_name>/<resource_name>/schema/	tastypie.resources.wrapper	api_get_schema
/api_tasty/<api_name>/<resource_name>/schema/	tastypie.resources.wrapper	api_get_schema
/api_tasty/<api_name>/<resource_name>/schema/	tastypie.resources.wrapper	api_get_schema
/api_tasty/<api_name>/<resource_name>/schema/	tastypie.resources.wrapper	api_get_schema
/api_tasty/<api_name>/<resource_name>/schema/	tastypie.resources.wrapper	api_get_schema
/api_tasty/<api_name>/<resource_name>/schema/	tastypie.resources.wrapper	api_get_schema
/api_tasty/<api_name>/<resource_name>/schema/	tastypie.resources.wrapper	api_get_schema
/api_tasty/<api_name>/<resource_name>/schema/	tastypie.resources.wrapper	api_get_schema
/api_tasty/<api_name>/<resource_name>/schema/	tastypie.resources.wrapper	api_get_schema
/api_tasty/<api_name>/<resource_name>/set/<pk_list>/	tastypie.resources.wrapper	api_get_multiple
/api_tasty/<api_name>/<resource_name>/set/<pk_list>/	tastypie.resources.wrapper	api_get_multiple
/api_tasty/<api_name>/<resource_name>/set/<pk_list>/	tastypie.resources.wrapper	api_get_multiple
/api_tasty/<api_name>/<resource_name>/set/<pk_list>/	tastypie.resources.wrapper	api_get_multiple
/api_tasty/<api_name>/<resource_name>/set/<pk_list>/	tastypie.resources.wrapper	api_get_multiple
/api_tasty/<api_name>/<resource_name>/set/<pk_list>/	tastypie.resources.wrapper	api_get_multiple
/api_tasty/<api_name>/<resource_name>/set/<pk_list>/	tastypie.resources.wrapper	api_get_multiple
/api_tasty/<api_name>/<resource_name>/set/<pk_list>/	tastypie.resources.wrapper	api_get_multiple
/api_tasty/<api_name>/<resource_name>/set/<pk_list>/	tastypie.resources.wrapper	api_get_multiple
/api_tasty/<api_name>/<resource_name>/set/<pk_list>/	tastypie.resources.wrapper	api_get_multiple
/api_tasty/<api_name>/<resource_name>/set/<pk_list>/	tastypie.resources.wrapper	api_get_multiple
/api_tasty/<api_name>/<resource_name>/set/<pk_list>/	tastypie.resources.wrapper	api_get_multiple
/articles/	tendenci.apps.articles.views.search	articles
/articles/<slug>/	tendenci.apps.articles.views.detail	article
/articles/add/	tendenci.apps.articles.views.add	article.add
/articles/delete/<id>/	tendenci.apps.articles.views.delete	article.delete
/articles/edit/<id>/	tendenci.apps.articles.views.edit	article.edit
/articles/edit/meta/<id>/	tendenci.apps.articles.views.edit_meta	article.edit.meta
/articles/export/	tendenci.apps.articles.views.export	article.export
/articles/export/download/<identifier>/	tendenci.apps.articles.views.export_download	article.export_download
/articles/export/status/<identifier>/	tendenci.apps.articles.views.export_status	article.export_status
/articles/feed/	tendenci.apps.articles.feeds.LatestEntriesFeed()	article.feed
/articles/print-view/<slug>/	tendenci.apps.articles.views.print_view	article.print_view
/articles/reports/rank/	tendenci.apps.articles.views.articles_report	reports-articles
/articles/search/	tendenci.apps.articles.views.search_redirect	article.search
/articles/versions/<hash>/	tendenci.apps.articles.views.detail	article.version
/base/addon/upload/	tendenci.apps.perms.decorators.decorator	addon.upload
/base/addon/upload/check/<sid>	tendenci.apps.base.views.addon_upload_check	addon.upload.check
/base/addon/upload/preview/<sid>	tendenci.apps.perms.decorators.decorator	addon.upload.preview
/base/addon/upload/status/<sid>	tendenci.apps.perms.decorators.decorator	addon.upload.process
/base/apps-list/	tendenci.apps.base.views.AppsListView	apps.list
/base/checklist/	tendenci.apps.perms.decorators.decorator	completion_checklist
/base/clear-cache/	tendenci.apps.base.views.clear_cache	clear_cache
/base/exception-test/	tendenci.apps.base.views.exception_test	exception_test
/base/feedback/	tendenci.apps.base.views.feedback	tendenci_feedback
/base/image-preview/<app_label>/<model>/<id>/<size>/	tendenci.apps.base.views.image_preview	image_preview
/base/memcached-status/	tendenci.apps.base.views.memcached_status	memcached_status
/base/password_again/	tendenci.apps.base.views.password_again	password_again
/base/setlang/	tendenci.apps.base.views.set_language	base.set_language
/base/timeout-test/	tendenci.apps.base.views.timeout_test	timeout_test
/base/update-tendenci/	tendenci.apps.perms.decorators.decorator	update_tendenci
/base/update-tendenci/confirmation/	tendenci.apps.perms.decorators.decorator	update_tendenci.confirmation
/boxes/export/	tendenci.apps.boxes.views.export	boxes.export
/calendar/	addons.tendenstreet.views.calendar.CalendarView	views.calendar
/calendar/<int:yyyy>-<int:mm>	addons.tendenstreet.views.calendar.CalendarView	views.calendar
/campaign_monitor/	tendenci.apps.campaign_monitor.views.template_index
/campaign_monitor/campaigns/	tendenci.apps.campaign_monitor.views.campaign_index	campaign_monitor.campaign_index
/campaign_monitor/campaigns/<campaign_id>/	tendenci.apps.campaign_monitor.views.campaign_view	campaign_monitor.campaign_view
/campaign_monitor/campaigns/delete/<campaign_id>/	tendenci.apps.campaign_monitor.views.campaign_delete	campaign_monitor.campaign_delete
/campaign_monitor/campaigns/generate/	tendenci.apps.campaign_monitor.views.campaign_generate	campaign_monitor.campaign_generate
/campaign_monitor/campaigns/sync/	tendenci.apps.campaign_monitor.views.campaign_sync	campaign_monitor.campaign_sync
/campaign_monitor/templates/	tendenci.apps.campaign_monitor.views.template_index	campaign_monitor.template_index
/campaign_monitor/templates/<template_id>/	tendenci.apps.campaign_monitor.views.template_view	campaign_monitor.template_view
/campaign_monitor/templates/<template_id>/delete/	tendenci.apps.campaign_monitor.views.template_delete	campaign_monitor.template_delete
/campaign_monitor/templates/<template_id>/edit/	tendenci.apps.campaign_monitor.views.template_edit	campaign_monitor.template_edit
/campaign_monitor/templates/<template_id>/original.html	tendenci.apps.campaign_monitor.views.template_html_original	campaign_monitor.template_html_original
/campaign_monitor/templates/<template_id>/page.html	tendenci.apps.campaign_monitor.views.template_html	campaign_monitor.template_html
/campaign_monitor/templates/<template_id>/render/	tendenci.apps.campaign_monitor.views.template_render	campaign_monitor.template_render
/campaign_monitor/templates/<template_id>/text/	tendenci.apps.campaign_monitor.views.template_text	campaign_monitor.template_text
/campaign_monitor/templates/<template_id>/update/	tendenci.apps.campaign_monitor.views.template_update	campaign_monitor.template_update
/campaign_monitor/templates/add/	tendenci.apps.campaign_monitor.views.template_add	campaign_monitor.template_add
/campaign_monitor/templates/sync/	tendenci.apps.campaign_monitor.views.template_sync	campaign_monitor.template_sync
/captcha/audio/<key>.wav	captcha.views.captcha_audio	captcha-audio
/captcha/image/<key>/	captcha.views.captcha_image	captcha-image
/captcha/image/<key>@2/	captcha.views.captcha_image	captcha-image-2x
/captcha/refresh/	captcha.views.captcha_refresh	captcha-refresh
/case-studies/	tendenci.apps.case_studies.views.search	case_study
/case-studies/<slug>/	tendenci.apps.case_studies.views.detail	case_study.view
/case-studies/feed/	tendenci.apps.case_studies.feeds.LatestEntriesFeed()	case_study.feed
/case-studies/print-view/<id>/	tendenci.apps.case_studies.views.print_view	case_study.print_view
/case-studies/search/	tendenci.apps.case_studies.views.search_redirect	case_study.search
/case-studies/service/<id>/	tendenci.apps.case_studies.views.service	case_study.service
/case-studies/technology/<id>/	tendenci.apps.case_studies.views.technology	case_study.technology
/categories/update/<app_label>/<model>/<pk>/	tendenci.apps.categories.views.edit_categories	category.update
/cid/	addons.tendenstreet.views.gov.cid	views.cid
/committees/	tendenci.apps.committees.views.search	committees.search
/committees/<slug>/	tendenci.apps.committees.views.detail	committees.detail
/committees/add/	tendenci.apps.committees.views.add	committees.add
/committees/delete/<id>/	tendenci.apps.committees.views.delete	committees.delete
/committees/edit/<id>/	tendenci.apps.committees.views.edit	committees.edit
/committees/edit/meta/<id>/	tendenci.apps.committees.views.edit_meta	committees.edit.meta
/committees/feed/	tendenci.apps.committees.feeds.LatestEntriesFeed()	committees.feed
/communique/	addons.tendenstreet.views.document_viewer.DocumentViewerView	views.document_viewer
/contact/	tendenci.apps.contacts.views.index	form
/contact/confirmation	tendenci.apps.contacts.views.confirmation	form.confirmation
/contacts/	tendenci.apps.contacts.views.search	contacts
/contacts/<id>/	tendenci.apps.contacts.views.details	contact
/contacts/delete/<id>/	tendenci.apps.contacts.views.delete	contact.delete
/contacts/print-view/<id>/	tendenci.apps.contacts.views.print_view	contact.print_view
/contacts/search/	tendenci.apps.contacts.views.search_redirect	contact.search
/contributions/	tendenci.apps.contributions.views.index	contribution
/contributions/<id>/	tendenci.apps.contributions.views.index	contribution
/contributions/search/	tendenci.apps.contributions.views.search	contribution.search
/corporatememberships/	tendenci.apps.corporate_memberships.views.search	corp_memb
/corporatememberships/	tendenci.apps.corporate_memberships.views.search	corp_memb.search
/corporatememberships/<slug>/add/	tendenci.apps.corporate_memberships.views.corpmembership_add	corpmembership.add
/corporatememberships/applications/<slug>/preview/	tendenci.apps.corporate_memberships.views.app_preview	corpmembership_app.preview
/corporatememberships/applications/add/	tendenci.apps.corporate_memberships.views.corpmembership_add	corpmembership.add
/corporatememberships/applications/add_conf/<id>/	tendenci.apps.corporate_memberships.views.corpmembership_add_conf	corpmembership.add_conf
/corporatememberships/applications/add_pre/	tendenci.apps.corporate_memberships.views.corpmembership_add_pre	corpmembership.add_pre
/corporatememberships/applications/approve/<id>/	tendenci.apps.corporate_memberships.views.corpmembership_approve	corpmembership.approve
/corporatememberships/applications/cap_status/	tendenci.apps.perms.decorators.decorator	corpmembership.cap_status
/corporatememberships/applications/delete/<id>/	tendenci.apps.corporate_memberships.views.corpmembership_delete	corpmembership.delete
/corporatememberships/applications/edit/<id>/	tendenci.apps.corporate_memberships.views.corpmembership_edit	corpmembership.edit
/corporatememberships/applications/index/	tendenci.apps.corporate_memberships.views.index	corpmembership.index
/corporatememberships/applications/mycorps/	tendenci.apps.corporate_memberships.views.corpmembership_search	corpmembership.mycorps
/corporatememberships/applications/pendings/	tendenci.apps.corporate_memberships.views.corpmembership_search	corpmembership.pending_list
/corporatememberships/applications/search/	tendenci.apps.corporate_memberships.views.corpmembership_search	corpmembership.search
/corporatememberships/applications/upgrade/<id>/	tendenci.apps.perms.decorators.decorator	corpmembership.upgrade
/corporatememberships/applications/view/<id>/	tendenci.apps.corporate_memberships.views.corpmembership_view	corpmembership.view
/corporatememberships/corp-export/	tendenci.apps.base.decorators.decorator	corpmembership.export
/corporatememberships/corp_reps_lookup/	tendenci.apps.corporate_memberships.views.corp_reps_lookup	corp_membership.reps_lookup
/corporatememberships/delete_corp_rep/<id>/	tendenci.apps.corporate_memberships.views.delete_corp_rep	corp_membership.delete_rep
/corporatememberships/download/<cm_id>/<field_id>/	tendenci.apps.corporate_memberships.views.download_file	corpmembership.download_file
/corporatememberships/edit_corp_reps/<id>/	tendenci.apps.corporate_memberships.views.edit_corp_reps	corpmembership.edit_corp_reps
/corporatememberships/free_passes/edit/<id>/	tendenci.apps.corporate_memberships.views.free_passes_edit	corpmembership.free_passes_edit
/corporatememberships/get_app_fields/	tendenci.apps.corporate_memberships.views.get_app_fields_json	corpmemberships.get_app_fields
/corporatememberships/import/	tendenci.apps.base.decorators.decorator	corpmembership.import
/corporatememberships/import/check_preprocess_status/<mimport_id>/	tendenci.apps.corporate_memberships.views.check_preprocess_status	corpmembership.check_preprocess_status
/corporatememberships/import/download/	tendenci.apps.corporate_memberships.views.download_template	corpmembership.download_template
/corporatememberships/import/get_status/<mimport_id>/	tendenci.apps.corporate_memberships.views.import_get_status	corpmembership.import_get_status
/corporatememberships/import/preview/<mimport_id>/	tendenci.apps.corporate_memberships.views.import_preview	corpmembership.import_preview
/corporatememberships/import/process/<mimport_id>/	tendenci.apps.corporate_memberships.views.import_process	corpmembership.import_process
/corporatememberships/import/status/<mimport_id>/	tendenci.apps.corporate_memberships.views.import_status	corpmembership.import_status
/corporatememberships/notices/logs/<id>/	tendenci.apps.corporate_memberships.notices.views.corporate_membership_notice_log_view	corporate_membership.notice.log.view
/corporatememberships/notices/logs/search/	tendenci.apps.corporate_memberships.notices.views.corporate_membership_notice_log_search	corporate_membership.notice.log.search
/corporatememberships/profiles/<id>/	tendenci.apps.corporate_memberships.views.corpprofile_view	corpmembership.view_profile
/corporatememberships/renewal/<id>/	tendenci.apps.corporate_memberships.views.corp_renew	corpmembership.renew
/corporatememberships/renewal_conf/<id>/	tendenci.apps.corporate_memberships.views.corp_renew_conf	corpmembership.renew_conf
/corporatememberships/reports/active_members_by_type/	tendenci.apps.corporate_memberships.views.report_active_corp_members_by_type	reports-active-corp-mems-by-type
/corporatememberships/reports/corp_members_by_status/	tendenci.apps.corporate_memberships.views.report_corp_members_by_status	reports-corp-mems-by-status
/corporatememberships/reports/corp_mems_over_time/	tendenci.apps.corporate_memberships.views.new_over_time_report	reports-corp-mems-over-time
/corporatememberships/reports/corp_mems_summary/	tendenci.apps.corporate_memberships.views.corp_mems_summary	reports-corp-mems-summary
/corporatememberships/reports/free_passes_list/	tendenci.apps.corporate_memberships.views.free_passes_list	corp_memb.reports.free_passes_list
/corporatememberships/reports/overview/	tendenci.apps.corporate_memberships.views.overview	corp_membership.overview
/corporatememberships/roster/	tendenci.apps.corporate_memberships.views.roster_search	corpmembership.roster_search
/dashboard/	tendenci.apps.dashboard.views.new	dashboard
/dashboard/customize/	tendenci.apps.perms.decorators.decorator	dashboard_customize
/dashboard/new/	tendenci.apps.dashboard.views.new	dashboard-new
/dashboard/old/	tendenci.apps.dashboard.views.index	dashboard-old
/directories/	tendenci.apps.directories.views.search	directories
/directories/<slug>/	tendenci.apps.directories.views.details	directory
/directories/add/	tendenci.apps.directories.views.add	directory.add
/directories/approve/<id>/	tendenci.apps.directories.views.approve	directory.approve
/directories/delete/<id>/	tendenci.apps.directories.views.delete	directory.delete
/directories/edit/<id>/	tendenci.apps.directories.views.edit	directory.edit
/directories/edit/meta/<id>/	tendenci.apps.directories.views.edit_meta	directory.edit.meta
/directories/export/	tendenci.apps.base.decorators.decorator	directory.export
/directories/export/download/<identifier>/	tendenci.apps.base.decorators.decorator	directory.export_download
/directories/export/status/<identifier>/	tendenci.apps.base.decorators.decorator	directory.export_status
/directories/feed/	tendenci.apps.directories.feeds.LatestEntriesFeed()	directory.feed
/directories/get_subcategories/	tendenci.apps.directories.views.get_subcategories	directory.get_subcategories
/directories/logo/<id>/	tendenci.apps.directories.views.logo_display	directory.logo
/directories/pending/	tendenci.apps.directories.views.pending	directory.pending
/directories/pricing/<id>/	tendenci.apps.directories.views.pricing_view	directory_pricing.view
/directories/pricing/add/	tendenci.apps.directories.views.pricing_add	directory_pricing.add
/directories/pricing/delete/<id>/	tendenci.apps.directories.views.pricing_delete	directory_pricing.delete
/directories/pricing/edit/<id>/	tendenci.apps.directories.views.pricing_edit	directory_pricing.edit
/directories/pricing/search/	tendenci.apps.directories.views.pricing_search	directory_pricing.search
/directories/print-view/<slug>/	tendenci.apps.directories.views.print_view	directory.print_view
/directories/query_price/	tendenci.apps.directories.views.query_price	directory.query_price
/directories/renew/<id>/	tendenci.apps.directories.views.renew	directory.renew
/directories/search/	tendenci.apps.directories.views.search_redirect	directory.search
/directories/thank-you/	tendenci.apps.directories.views.thank_you	directory.thank_you
/directory/<cat>/	addons.custom_directories.views.category	directory.category
/directory/<cat>/	addons.custom_directories.views.category	directory.category
/directory/<cat>/print/	addons.custom_directories.views.print	directory.print
/directory/<cat>/print/	addons.custom_directories.views.print	directory.print
/discounts/	tendenci.apps.discounts.views.search	discounts
/discounts/add/	tendenci.apps.discounts.views.add	discount.add
/discounts/check_discount/	tendenci.apps.discounts.views.discounted_prices	discount.check_discount
/discounts/delete/<id>/	tendenci.apps.discounts.views.delete	discount.delete
/discounts/detail/<id>/	tendenci.apps.discounts.views.detail	discount.detail
/discounts/discounted_price/	tendenci.apps.discounts.views.discounted_price	discount.discounted_price
/discounts/discounted_prices/	tendenci.apps.discounts.views.discounted_prices	discount.discounted_prices
/discounts/edit/<id>/	tendenci.apps.discounts.views.edit	discount.edit
/discounts/export/	tendenci.apps.discounts.views.export	discount.export
/donations/	tendenci.apps.donations.views.add	donation.add
/donations/<id>/	tendenci.apps.donations.views.detail	donation.view
/donations/conf/<id>/	tendenci.apps.donations.views.add_confirm	donation.add_confirm
/donations/receipt/<id>/<guid>/	tendenci.apps.donations.views.receipt	donation.receipt
/donations/search/	tendenci.apps.donations.views.search	donation.search
/emails/	tendenci.apps.emails.views.search	emails
/emails/<id>/	tendenci.apps.emails.views.view	email.view
/emails/add/	tendenci.apps.emails.views.add	email.add
/emails/amazon_ses/	tendenci.apps.emails.views.amazon_ses_index	email.amazon_ses_index
/emails/amazon_ses/list_verified_emails/	tendenci.apps.emails.views.amazon_ses_list_verified_emails	email.amazon_ses_list_verified_emails
/emails/amazon_ses/send_quota/	tendenci.apps.emails.views.amazon_ses_send_quota	email.amazon_ses_send_quota
/emails/amazon_ses/verify_email/	tendenci.apps.emails.views.amazon_ses_verify_email	email.amazon_ses_verify_email
/emails/delete/<id>/	tendenci.apps.emails.views.delete	email.delete
/emails/edit/<id>/	tendenci.apps.emails.views.edit	email.edit
/emails/search/	tendenci.apps.emails.views.search	email.search
/emails/viewbody/<id>/	tendenci.apps.emails.views.view	email.viewbody
/en/	django.views.generic.base.RedirectView
/entities/	tendenci.apps.entities.views.index	entities
/entities/<id>/	tendenci.apps.entities.views.index	entity
/entities/add/	tendenci.apps.entities.views.add	entity.add
/entities/delete/<id>/	tendenci.apps.entities.views.delete	entity.delete
/entities/edit/<id>/	tendenci.apps.entities.views.edit	entity.edit
/entities/print-view/<id>/	tendenci.apps.entities.views.print_view	entity.print_view
/entities/search/	tendenci.apps.entities.views.search	entity.search
/event-logs/	tendenci.apps.event_logs.views.index	event_logs
/event-logs/<id>/	tendenci.apps.event_logs.views.index	event_log
/event-logs/colored-image/<color>/	tendenci.apps.event_logs.views.colored_image	event_log.colored_image
/event-logs/info/	tendenci.apps.perms.decorators.decorator	event_log.info
/event-logs/print-view/<id>/	tendenci.apps.event_logs.views.print_view	event_log.print_view
/event-logs/reports/summary/	tendenci.apps.perms.decorators.decorator	reports-events-summary
/event-logs/reports/summary/application/<application>/	tendenci.apps.perms.decorators.decorator	reports-events-application
/event-logs/search/	tendenci.apps.event_logs.views.search	event_log.search
/events/	addons.tendenstreet.views.calendar.EventsView	views.events
/eventually/	tendenci.apps.events.views.month_redirect	events
/eventually/<event_id>/addons/<addon_id>/delete/	tendenci.apps.events.views.delete_addon	event.delete_addon
/eventually/<event_id>/addons/<addon_id>/disable/	tendenci.apps.events.views.disable_addon	event.disable_addon
/eventually/<event_id>/addons/<addon_id>/edit/	tendenci.apps.events.views.edit_addon	event.edit_addon
/eventually/<event_id>/addons/<addon_id>/enable/	tendenci.apps.events.views.enable_addon	event.enable_addon
/eventually/<event_id>/addons/add/	tendenci.apps.events.views.add_addon	event.add_addon
/eventually/<event_id>/addons/list/	tendenci.apps.events.views.list_addons	event.list_addons
/eventually/<event_id>/attendees	tendenci.apps.events.views.view_attendees	event.attendees
/eventually/<event_id>/registrants/cancel/<hash>/	tendenci.apps.events.views.cancel_registrant	event.cancel_registrant
/eventually/<event_id>/registrants/cancel/<registrant_id>/	tendenci.apps.events.views.cancel_registrant	event.cancel_registrant
/eventually/<event_id>/registrants/export/	tendenci.apps.events.views.registrant_export_with_custom	event.registrant.export
/eventually/<event_id>/registrants/export/non-paid	tendenci.apps.events.views.registrant_export_with_custom	event.registrant.export.non_paid
/eventually/<event_id>/registrants/export/paid	tendenci.apps.events.views.registrant_export_with_custom	event.registrant.export.paid
/eventually/<event_id>/registrants/export/total	tendenci.apps.events.views.registrant_export_with_custom	event.registrant.export.total
/eventually/<event_id>/registrants/roster/	tendenci.apps.events.views.registrant_roster	event.registrant.roster
/eventually/<event_id>/registrants/roster/non-paid	tendenci.apps.events.views.registrant_roster	event.registrant.roster.non_paid
/eventually/<event_id>/registrants/roster/paid	tendenci.apps.events.views.registrant_roster	event.registrant.roster.paid
/eventually/<event_id>/registrants/roster/total	tendenci.apps.events.views.registrant_roster	event.registrant.roster.total
/eventually/<event_id>/registrants/search/	tendenci.apps.events.views.registrant_search	event.registrant.search
/eventually/<event_id>/registrations/cancel/<registration_id>/	tendenci.apps.events.views.cancel_registration	event.cancel_registration
/eventually/<event_id>/registrations/cancel/<registration_id>/<hash>/	tendenci.apps.events.views.cancel_registration	event.cancel_registration
/eventually/<event_id>/speakers/	tendenci.apps.events.views.speaker_list	event.speakers
/eventually/<id>/	tendenci.apps.events.views.details	event
/eventually/<id>/<private_slug>/	tendenci.apps.events.views.details	event.private_details
/eventually/<id>/registrations/<hash>/	tendenci.apps.events.views.registration_confirmation	event.registration_confirmation
/eventually/<id>/registrations/<reg8n_id>/	tendenci.apps.events.views.registration_confirmation	event.registration_confirmation
/eventually/<type>/	tendenci.apps.events.views.month_view	event.month
/eventually/<year>/<month>/	tendenci.apps.events.views.month_view	event.month
/eventually/<year>/<month>/<day>/	tendenci.apps.events.views.day_view	event.day
/eventually/<year>/<month>/<type>/	tendenci.apps.events.views.month_view	event.month
/eventually/add-from-template/<id>/	tendenci.apps.events.views.add_from_template	event.add_from_template
/eventually/add/	tendenci.apps.events.views.add	event.add
/eventually/add/<year>/<month>/<day>/	tendenci.apps.events.views.add	event.add
/eventually/add/template/	tendenci.apps.events.views.add	event.add_template
/eventually/check_free_pass_eligibility/	tendenci.apps.events.views.check_free_pass_eligibility	event.check_free_pass_eligibility
/eventually/copy/<id>/	tendenci.apps.events.views.copy	event.copy
/eventually/create_ics/	tendenci.apps.events.views.create_ics	event.create_ics
/eventually/custom_reg_form/list/<event_id>/	tendenci.apps.events.views.event_custom_reg_form_list	event.event_custom_reg_form_list
/eventually/custom_reg_form/preview/<id>/	tendenci.apps.events.views.custom_reg_form_preview	event.custom_reg_form_preview
/eventually/delete/<id>/	tendenci.apps.events.views.delete	event.delete
/eventually/delete_recurring/<id>/	tendenci.apps.events.views.delete_recurring	event.delete_recurring
/eventually/edit/email/<event_id>/	tendenci.apps.events.views.edit_email	event.edit.email
/eventually/edit/meta/<id>/	tendenci.apps.events.views.edit_meta	event.edit.meta
/eventually/export/	tendenci.apps.base.decorators.decorator	event.export
/eventually/export/download/<identifier>/	tendenci.apps.base.decorators.decorator	event.export_download
/eventually/export/status/<identifier>/	tendenci.apps.base.decorators.decorator	event.export_status
/eventually/feed/	tendenci.apps.events.feeds.LatestEntriesFeed()	event.feed
/eventually/get_place	tendenci.apps.events.views.get_place	event.get_place
/eventually/ics/	tendenci.apps.events.views.icalendar	event.ics
/eventually/ics/<id>/	tendenci.apps.events.views.icalendar_single	event.ics_single
/eventually/import/add/	tendenci.apps.events.views.import_add	event.import_add
/eventually/import/download_template/	tendenci.apps.events.views.download_template_csv	event.download_template_csv
/eventually/import/preview/<import_id>/	tendenci.apps.events.views.import_preview	event.import_preview
/eventually/import/process/<import_id>/	tendenci.apps.events.views.import_process	event.import_process
/eventually/location/edit/<id>/	tendenci.apps.events.views.location_edit	event.location_edit
/eventually/member-register/<event_id>/	tendenci.apps.perms.decorators.decorator	event.member_register
/eventually/message/<event_id>/	tendenci.apps.events.views.message_add	event.message
/eventually/minimal_add/	tendenci.apps.events.views.minimal_add	event.minimal_add
/eventually/month/	tendenci.apps.events.views.month_view	event.month
/eventually/myevents/	tendenci.apps.events.views.myevents	event.myevents
/eventually/organizer/edit/<id>/	tendenci.apps.events.views.organizer_edit	event.organizer_edit
/eventually/overview/edit/<id>/	tendenci.apps.events.views.edit	event.edit
/eventually/pending/	tendenci.apps.events.views.pending	event.pending
/eventually/pending/<event_id>/approve/	tendenci.apps.events.views.approve	event.approve
/eventually/pricing/edit/<id>/	tendenci.apps.events.views.pricing_edit	event.pricing_edit
/eventually/print-view/<id>/	tendenci.apps.events.views.print_view	event.print_view
/eventually/reassign_type/<type_id>	tendenci.apps.events.views.reassign_type	event.reassign_type
/eventually/recurring/<id>/	tendenci.apps.events.views.recurring_details	event.recurring
/eventually/regconf/edit/<id>/	tendenci.apps.events.views.regconf_edit	event.regconf_edit
/eventually/register/<event_id>/	tendenci.apps.events.views.register	event.register
/eventually/register/<event_id>/individual/<pricing_id>/	tendenci.apps.events.views.register	event.register_individual
/eventually/register/<event_id>/pre/	tendenci.apps.events.views.register_pre	event.register_pre
/eventually/register/<event_id>/table/<pricing_id>/	tendenci.apps.events.views.register	event.register_table
/eventually/registrant/checkin/	tendenci.apps.events.views.registrant_check_in	event.registrant_check_in
/eventually/registrants/<id>/	tendenci.apps.events.views.registrant_details	event.registrant
/eventually/registrants/search/	tendenci.apps.events.views.global_registrant_search	event.global.registrant.search
/eventually/registration/<reg8n_id>/edit/	tendenci.apps.events.views.registration_edit	event.registration_edit
/eventually/registration/<reg8n_id>/edit/<hash>/	tendenci.apps.events.views.registration_edit	event.registration_edit
/eventually/reports/financial/	tendenci.apps.events.views.reports_financial	event.reports.financial
/eventually/reports/financial/download/<identifier>/	tendenci.apps.events.views.financial_export_download	event.reports.financial.export_download
/eventually/reports/financial/export_status/<identifier>	tendenci.apps.events.views.financial_export_status	event.reports.financial.export_status
/eventually/search/	tendenci.apps.events.views.search	event.search
/eventually/search/past/	tendenci.apps.events.views.search	event.past_search
/eventually/speaker/<id>/delete/	tendenci.apps.events.views.delete_speaker	event.delete_speaker
/eventually/speakers/edit/<id>/	tendenci.apps.events.views.speaker_edit	event.speaker_edit
/eventually/sponsor/edit/<id>/	tendenci.apps.events.views.sponsor_edit	event.sponsor_edit
/eventually/templates/	tendenci.apps.events.views.templates_list	event.templates_list
/eventually/today/	tendenci.apps.events.views.today_redirect	event.today
/eventually/types/	tendenci.apps.events.views.types	event.types
/eventually/week/	tendenci.apps.events.views.week_view	event.week
/eventually/week/<year>/<month>/<day>/	tendenci.apps.events.views.week_view	event.week
/eventually/week/<year>/<month>/<day>/<type>/	tendenci.apps.events.views.week_view	event.week
/explorer/	explorer.views.ListQueryView	explorer_index
/explorer/<pk>/delete	explorer.views.DeleteQueryView	query_delete
/explorer/<query_id>/	explorer.views.QueryView	query_detail
/explorer/<query_id>/download	explorer.views.DownloadQueryView	download_query
/explorer/<query_id>/email_csv	explorer.views.EmailCsvQueryView	email_csv_query
/explorer/<query_id>/stream	explorer.views.StreamQueryView	stream_query
/explorer/download	explorer.views.DownloadFromSqlView	download_sql
/explorer/export/<dump_id>/delete/	tendenci.apps.explorer_extensions.views.delete_dump	explorer_extensions.delete_dump
/explorer/export/<dump_id>/download/	tendenci.apps.explorer_extensions.views.download_dump	explorer_extensions.download_dump
/explorer/export_database/	tendenci.apps.explorer_extensions.views._ExportPage	explorer_extensions.export_page
/explorer/format/	explorer.views.format_sql	format_sql
/explorer/logs/	explorer.views.ListQueryLogView	explorer_logs
/explorer/new/	explorer.views.CreateQueryView	query_create
/explorer/play/	explorer.views.PlayQueryView	explorer_playground
/explorer/schema/<connection>	explorer.views.SchemaView	explorer_schema
/exports/<export_id>/	tendenci.apps.exports.views.status	export.status
/exports/<export_id>/download/	tendenci.apps.exports.views.download	export.download
/files/	tendenci.apps.files.views.search	files
/files/<id>	tendenci.apps.files.views.details	file_no_trailing_slash
/files/<id>/	tendenci.apps.files.views.details	file
/files/<id>/<download>/	tendenci.apps.files.views.details	file
/files/<id>/<size>	tendenci.apps.files.views.details	file_no_trailing_slash
/files/<id>/<size>/	tendenci.apps.files.views.details	file
/files/<id>/<size>/<constrain>	tendenci.apps.files.views.details	file_no_trailing_slash
/files/<id>/<size>/<constrain>/	tendenci.apps.files.views.details	file
/files/<id>/<size>/<constrain>/<quality>	tendenci.apps.files.views.details	file_no_trailing_slash
/files/<id>/<size>/<constrain>/<quality>/	tendenci.apps.files.views.details	file
/files/<id>/<size>/<crop>	tendenci.apps.files.views.details	file_no_trailing_slash
/files/<id>/<size>/<crop>/	tendenci.apps.files.views.details	file
/files/<id>/<size>/<crop>/<quality>	tendenci.apps.files.views.details	file_no_trailing_slash
/files/<id>/<size>/<crop>/<quality>/	tendenci.apps.files.views.details	file
/files/<id>/<size>/<download>/	tendenci.apps.files.views.details	file
/files/<id>/<size>/<download>/<constrain>/	tendenci.apps.files.views.details	file
/files/<id>/<size>/<quality>	tendenci.apps.files.views.details	file_no_trailing_slash
/files/<id>/<size>/<quality>/	tendenci.apps.files.views.details	file
/files/add/	tendenci.apps.files.views.add	file.add
/files/delete/<id>/	tendenci.apps.files.views.delete	file.delete
/files/edit/<id>/	tendenci.apps.files.views.edit	file.edit
/files/get_categories/	tendenci.apps.files.views.get_categories	file.get_categories
/files/reports/most-viewed/	tendenci.apps.perms.decorators.decorator	file.report_most_viewed
/files/search/	tendenci.apps.files.views.search_redirect	file.search
/files/tinymce-fb/	tendenci.apps.files.views.tinymce_fb	file.tinymce_fb
/files/tinymce/upload/	tendenci.apps.files.views.FileTinymceCreateView	file.tinymce_upload
/forms/	tendenci.apps.forms_builder.forms.views.search	forms
/forms/<slug>/	tendenci.apps.forms_builder.forms.views.form_detail	form_detail
/forms/<slug>/sent/	tendenci.apps.forms_builder.forms.views.form_sent	form_sent
/forms/add/	tendenci.apps.forms_builder.forms.views.add	form_add
/forms/copy/<id>	tendenci.apps.forms_builder.forms.views.copy	form_copy
/forms/delete/<id>	tendenci.apps.forms_builder.forms.views.delete	form_delete
/forms/edit/<id>	tendenci.apps.forms_builder.forms.views.edit	form_edit
/forms/entries/<id>	tendenci.apps.forms_builder.forms.views.entries	form_entries
/forms/entries/delete/<id>	tendenci.apps.forms_builder.forms.views.entry_delete	form_entry_delete
/forms/entries/export/<id>/full	tendenci.apps.forms_builder.forms.views.entries_export	form_entries_export_full
/forms/entries/export/<task_id>/check/	tendenci.apps.forms_builder.forms.views.entries_export_check	form_entries_export_check
/forms/entries/export/<task_id>/download/	tendenci.apps.forms_builder.forms.views.entries_export_download	form_entries_export_download
/forms/entries/export/<task_id>/status/	tendenci.apps.forms_builder.forms.views.entries_export_status	form_entries_export_status
/forms/entry/<id>	tendenci.apps.forms_builder.forms.views.entry_detail	form_entry_detail
/forms/export/	tendenci.apps.forms_builder.forms.views.export	form_export
/forms/files/<id>	tendenci.apps.forms_builder.forms.views.files	form_files
/forms/payment/<invoice_id>/<invoice_guid>/	tendenci.apps.forms_builder.forms.views.form_entry_payment	form_entry_payment
/forms/update_fields/<id>	tendenci.apps.forms_builder.forms.views.update_fields	form_field_update
/forums/	tendenci.apps.forums.views.IndexView	pybb:index
/forums/api/post_ajax_preview/	tendenci.apps.forums.views.post_ajax_preview	pybb:post_ajax_preview
/forums/block_user/<var>/	tendenci.apps.forums.views.block_user	pybb:block_user
/forums/c/<category_slug>/<forum_slug>/<slug>/	tendenci.apps.forums.views.TopicView	pybb:topic
/forums/c/<category_slug>/<slug>/	tendenci.apps.forums.views.ForumView	pybb:forum
/forums/c/<slug>/	tendenci.apps.forums.views.CategoryView	pybb:category
/forums/category/<pk>/	tendenci.apps.forums.views.CategoryView	pybb:category
/forums/feeds/posts/	tendenci.apps.forums.feeds.LastPosts()	pybb:feed_posts
/forums/feeds/topics/	tendenci.apps.forums.feeds.LastTopics()	pybb:feed_topics
/forums/forum/<forum_id>/topic/add/	tendenci.apps.forums.views.AddPostView	pybb:add_topic
/forums/forum/<pk>/	tendenci.apps.forums.views.ForumView	pybb:forum
/forums/mark_all_as_read/	tendenci.apps.forums.views.mark_all_as_read	pybb:mark_all_as_read
/forums/post/<pk>/	tendenci.apps.forums.views.PostView	pybb:post
/forums/post/<pk>/delete/	tendenci.apps.forums.views.DeletePostView	pybb:delete_post
/forums/post/<pk>/edit/	tendenci.apps.forums.views.EditPostView	pybb:edit_post
/forums/post/<pk>/moderate/	tendenci.apps.forums.views.ModeratePost	pybb:moderate_post
/forums/profile/edit/	tendenci.apps.forums.views.ProfileEditView	pybb:edit_profile
/forums/subscription/topic/<var>/add/	tendenci.apps.forums.views.add_subscription	pybb:add_subscription
/forums/subscription/topic/<var>/delete/	tendenci.apps.forums.views.delete_subscription	pybb:delete_subscription
/forums/topic/<pk>/	tendenci.apps.forums.views.TopicView	pybb:topic
/forums/topic/<pk>/cancel_poll_vote/	tendenci.apps.forums.views.topic_cancel_poll_vote	pybb:topic_cancel_poll_vote
/forums/topic/<pk>/close/	tendenci.apps.forums.views.CloseTopicView	pybb:close_topic
/forums/topic/<pk>/open/	tendenci.apps.forums.views.OpenTopicView	pybb:open_topic
/forums/topic/<pk>/poll_vote/	tendenci.apps.forums.views.TopicPollVoteView	pybb:topic_poll_vote
/forums/topic/<pk>/stick/	tendenci.apps.forums.views.StickTopicView	pybb:stick_topic
/forums/topic/<pk>/unstick/	tendenci.apps.forums.views.UnstickTopicView	pybb:unstick_topic
/forums/topic/<topic_id>/post/add/	tendenci.apps.forums.views.AddPostView	pybb:add_post
/forums/topic/latest/	tendenci.apps.forums.views.LatestTopicsView	pybb:topic_latest
/forums/unblock_user/<var>/	tendenci.apps.forums.views.unblock_user	pybb:unblock_user
/forums/users/<username>/	tendenci.apps.forums.views.UserView	pybb:user
/forums/users/<username>/posts/	tendenci.apps.forums.views.UserPosts	pybb:user_posts
/forums/users/<username>/topics/	tendenci.apps.forums.views.UserTopics	pybb:user_topics
/groups/	tendenci.apps.user_groups.views.search	groups
/groups/<group_slug>/	tendenci.apps.user_groups.views.group_detail	group.detail
/groups/<group_slug>/<newsletter_key>/newsletters/unsubscribe/noninteractive/	tendenci.apps.user_groups.views.unsubscribe_to_newsletter_noninteractive	group.newsletter_unsubscribe_noninteractive
/groups/<group_slug>/adduser/	tendenci.apps.user_groups.views.groupmembership_bulk_add	group.adduser
/groups/<group_slug>/deleteuser/<user_id>/	tendenci.apps.user_groups.views.groupmembership_delete	group.deleteuser
/groups/<group_slug>/edit/	tendenci.apps.user_groups.views.group_add_edit	group.edit
/groups/<group_slug>/edituser/<user_id>/	tendenci.apps.user_groups.views.groupmembership_add_edit	group.edituser
/groups/<group_slug>/export/<export_target>/	tendenci.apps.user_groups.views.group_members_export	group.members_export
/groups/<group_slug>/export/<export_target>/download/<identifier>/	tendenci.apps.user_groups.views.group_members_export_download	group.members_export_download
/groups/<group_slug>/export/<export_target>/status/<identifier>/	tendenci.apps.user_groups.views.group_members_export_status	group.members_export_status
/groups/<group_slug>/export/all/	tendenci.apps.user_groups.views.group_all_export	group.all_export
/groups/<group_slug>/export/members/	tendenci.apps.user_groups.views.group_member_export	group.member_export
/groups/<group_slug>/export/subscribers/	tendenci.apps.user_groups.views.group_subscriber_export	group.subscriber_export
/groups/<group_slug>/import/status/<task_id>/	tendenci.apps.user_groups.views.subscribers_import_status	subscribers_import_status
/groups/<group_slug>/import/subscribers/	tendenci.apps.user_groups.views.group_subscriber_import	group.subscriber_import
/groups/<group_slug>/message/	tendenci.apps.perms.decorators.decorator	group.message
/groups/<group_slug>/newsletters/subscribe/interactive/	tendenci.apps.user_groups.views.subscribe_to_newsletter_interactive	group.newsletter_subscribe_interactive
/groups/<group_slug>/newsletters/unsubscribe/interactive/	tendenci.apps.user_groups.views.unsubscribe_to_newsletter_interactive	group.newsletter_unsubscribe_interactive
/groups/<slug>/selfadd/<user_id>/	tendenci.apps.user_groups.views.group_membership_self_add	group.selfadd
/groups/<slug>/selfremove/<user_id>/	tendenci.apps.user_groups.views.group_membership_self_remove	group.selfremove
/groups/add/	tendenci.apps.user_groups.views.group_add_edit	group.add
/groups/adduser/redirect/	tendenci.apps.user_groups.views.groupmembership_bulk_add_redirect	group.adduser_redirect
/groups/delete/<id>/	tendenci.apps.user_groups.views.group_delete	group.delete
/groups/edit_perms/<id>/	tendenci.apps.user_groups.views.group_edit_perms	group.edit_perms
/groups/import/add/	tendenci.apps.base.decorators.decorator	group.import_add
/groups/import/download_template/	tendenci.apps.user_groups.views.import_download_template	group.import_download_template
/groups/import/preview/<import_id>/	tendenci.apps.user_groups.views.import_preview	group.import_preview
/groups/import/process/<import_id>/	tendenci.apps.user_groups.views.import_process	group.import_process
/groups/search/	tendenci.apps.user_groups.views.search_redirect	group.search
/help-files/	tendenci.apps.help_files.views.index	help_files
/help-files/<slug>/	tendenci.apps.help_files.views.detail	help_file.details
/help-files/add/	tendenci.apps.help_files.views.add	help_files.add
/help-files/edit/<id>/	tendenci.apps.help_files.views.edit	help_files.edit
/help-files/export/	tendenci.apps.help_files.views.export	help_files.export
/help-files/feed/	tendenci.apps.help_files.feeds.LatestEntriesFeed()	help_files.feed
/help-files/request/	tendenci.apps.help_files.views.request_new	help_files.request
/help-files/requests/	tendenci.apps.help_files.views.requests	help_files.requests
/help-files/search/	tendenci.apps.help_files.views.search	help_files.search
/help-files/topic/<id>/	tendenci.apps.help_files.views.topic	help_files.topic
/ics/<ics_id>/	tendenci.apps.events.ics.views.status	ics.status
/ics/<ics_id>/download/	tendenci.apps.events.ics.views.download	ics.download
/imports/users/upload/add/	tendenci.apps.base.decorators.decorator	import.user_upload_add
/imports/users/upload/formats/	tendenci.apps.imports.views.download_user_upload_template	import.download_user_upload_template_xls
/imports/users/upload/formats/csv/	tendenci.apps.imports.views.download_user_upload_template	import.download_user_upload_template_csv
/imports/users/upload/preview/<sid>	tendenci.apps.imports.views.user_upload_preview	import.user_upload_preview
/imports/users/upload/process/<sid>	tendenci.apps.imports.views.user_upload_process	import.user_upload_process
/imports/users/upload/recap/<sid>	tendenci.apps.imports.views.user_upload_recap	import.user_upload_recap
/imports/users/upload/subprocess/<sid>	tendenci.apps.imports.views.user_upload_subprocess	import.user_upload_subprocess
/invoices/	tendenci.apps.invoices.views.search	invoices
/invoices/<id>/<guid>	tendenci.apps.invoices.views.view	invoice.view
/invoices/adjust/<id>/	tendenci.apps.invoices.views.adjust	invoice.adjust
/invoices/detail/<id>/	tendenci.apps.invoices.views.detail	invoice.detail
/invoices/download/<id>/	tendenci.apps.invoices.views.download_pdf	invoice.download
/invoices/email/<invoice_id>/	tendenci.apps.invoices.views.email_invoice	invoice.email
/invoices/export/	tendenci.apps.base.decorators.decorator	invoice.export
/invoices/export/download/<identifier>/	tendenci.apps.base.decorators.decorator	invoice.export_download
/invoices/export/status/<identifier>/	tendenci.apps.base.decorators.decorator	invoice.export_status
/invoices/mark-as-paid/<id>/	tendenci.apps.invoices.views.mark_as_paid	invoice.mark_as_paid
/invoices/print/<id>/<guid>	tendenci.apps.invoices.views.view	invoice.print_view
/invoices/report/top_spenders/	tendenci.apps.invoices.views.report_top_spenders	reports-top-spenders
/invoices/search/	tendenci.apps.invoices.views.search	invoice.search
/invoices/void-invoice/<id>/	tendenci.apps.perms.decorators.decorator	invoice.void_invoice
/invoices/void_payment/<id>/	tendenci.apps.invoices.views.void_payment	invoice.void_payment
/jobs/	tendenci.apps.jobs.views.search	jobs
/jobs/<slug>/	tendenci.apps.jobs.views.detail	job
/jobs/add/	tendenci.apps.jobs.views.add	job.add
/jobs/approve/<id>/	tendenci.apps.jobs.views.approve	job.approve
/jobs/delete/<id>/	tendenci.apps.jobs.views.delete	job.delete
/jobs/edit/<id>/	tendenci.apps.jobs.views.edit	job.edit
/jobs/edit/meta/<id>/	tendenci.apps.jobs.views.edit_meta	job.edit.meta
/jobs/export/	tendenci.apps.jobs.views.export	job.export
/jobs/feed/	tendenci.apps.jobs.feeds.LatestEntriesFeed()	job.feed
/jobs/get_subcategories/	tendenci.apps.jobs.views.get_subcategories	job.get_subcategories
/jobs/my-jobs/	tendenci.apps.jobs.views.my_jobs	myjobs
/jobs/pending/	tendenci.apps.jobs.views.pending	job.pending
/jobs/pricing/<id>/	tendenci.apps.jobs.views.pricing_view	job_pricing.view
/jobs/pricing/add/	tendenci.apps.jobs.views.pricing_add	job_pricing.add
/jobs/pricing/delete/<id>/	tendenci.apps.jobs.views.pricing_delete	job_pricing.delete
/jobs/pricing/edit/<id>/	tendenci.apps.jobs.views.pricing_edit	job_pricing.edit
/jobs/pricing/search/	tendenci.apps.jobs.views.pricing_search	job_pricing.search
/jobs/print-view/<slug>/	tendenci.apps.jobs.views.print_view	job.print_view
/jobs/query_price/	tendenci.apps.jobs.views.query_price	job.query_price
/jobs/search/	tendenci.apps.jobs.views.search_redirect	job.search
/jobs/thank-you/	tendenci.apps.jobs.views.thank_you	job.thank_you
/locations/	tendenci.apps.locations.views.search	locations
/locations/<slug>/	tendenci.apps.locations.views.detail	location
/locations/add/	tendenci.apps.locations.views.add	location.add
/locations/delete/<id>/	tendenci.apps.locations.views.delete	location.delete
/locations/edit/<id>/	tendenci.apps.locations.views.edit	location.edit
/locations/export/	tendenci.apps.locations.views.export	locations_export
/locations/feed/	tendenci.apps.locations.feeds.LatestEntriesFeed()	locations.feed
/locations/import/	tendenci.apps.perms.decorators.decorator	locations_import_upload_file
/locations/import/confirm/<id>/	tendenci.apps.perms.decorators.decorator	locations_import_confirm
/locations/import/preview/<id>/	tendenci.apps.perms.decorators.decorator	locations_import_preview
/locations/import/status/<task_id>/	tendenci.apps.perms.decorators.decorator	locations_import_status
/locations/nearest/	tendenci.apps.locations.views.nearest	location.nearest
/locations/print-view/<id>/	tendenci.apps.locations.views.print_view	location.print_view
/locations/search/	tendenci.apps.locations.views.search_redirect	location.search
/locations/upload/formats/csv/	tendenci.apps.perms.decorators.decorator	locations.download_location_upload_template_csv
/login/	django.views.generic.base.RedirectView
/media/<path>	django.views.static.serve
/memberships/	tendenci.apps.memberships.views.membership_index	membership.index
/memberships/<id>/	tendenci.apps.memberships.views.membership_details	membership.details
/memberships/applications/	tendenci.apps.memberships.views.membership_applications	membership-applications
/memberships/applications/<id>/edit/	tendenci.apps.memberships.views.membership_default_edit	membership_default.edit
/memberships/applications/<slug>/	tendenci.apps.memberships.views.membership_default_add	membership_default.add
/memberships/applications/<slug>/<membership_id>/	tendenci.apps.memberships.views.membership_default_add	membership_default.renew
/memberships/applications/<slug>/preview/	tendenci.apps.memberships.views.membership_default_preview	membership_default.preview
/memberships/applications/add/	tendenci.apps.memberships.views.membership_default_add_legacy	membership_default.add
/memberships/applications/add/<cm_id>/	tendenci.apps.memberships.views.membership_default_add	membership_default.add_under_corp
/memberships/applications/add/<cm_id>/<imv_id>/<imv_guid>/	tendenci.apps.memberships.views.membership_default_add	membership_default.add_via_corp_domain
/memberships/applications/add/<cm_id>/<secret_hash>	tendenci.apps.memberships.views.membership_default_add	membership.add_via_corp_secret_code
/memberships/applications/corp-pre-add/<cm_id>/	tendenci.apps.memberships.views.membership_default_corp_pre_add	membership_default.corp_pre_add
/memberships/applications/renew/<cm_id>/<membership_id>/	tendenci.apps.memberships.views.membership_default_add	membership_default.renew_under_corp
/memberships/auto_renew_setup/<user_id>/	tendenci.apps.memberships.views.memberships_auto_renew_setup	memberships.auto_renew_setup
/memberships/default-application/<cmb_id>/	tendenci.apps.memberships.views.application_detail_default	membership.application_detail_default
/memberships/default-confirmation/<hash>/	tendenci.apps.memberships.views.application_confirmation_default	membership.application_confirmation_default
/memberships/delete/<id>/	tendenci.apps.memberships.views.delete	membership.delete
/memberships/emailtoverify/conf/	tendenci.apps.memberships.views.email_to_verify_conf	membership.email__to_verify_conf
/memberships/entries/search/	tendenci.apps.memberships.views.application_entries_search	membership.application_entries_search
/memberships/expire/<id>/	tendenci.apps.memberships.views.expire	membership.expire
/memberships/export/	tendenci.apps.base.decorators.decorator	memberships.default_export
/memberships/export/check_status/<identifier>/	tendenci.apps.memberships.views.membership_default_export_check_status	memberships.default_export_check_status
/memberships/export/download/<identifier>/	tendenci.apps.base.decorators.decorator	memberships.default_export_download
/memberships/export/status/<identifier>/	tendenci.apps.base.decorators.decorator	memberships.default_export_status
/memberships/get_app_fields/	tendenci.apps.memberships.views.get_app_fields_json	memberships.get_app_fields
/memberships/get_taken_fields/	tendenci.apps.memberships.views.get_taken_fields	memberships.get_taken_fields
/memberships/import_default/	tendenci.apps.base.decorators.decorator	memberships.default_import
/memberships/import_default/check_encode_status/<mimport_id>/	tendenci.apps.memberships.views.membership_default_import_check_preprocess_status	memberships.default_import_check_preprocess_status
/memberships/import_default/download/	tendenci.apps.memberships.views.download_default_template	memberships.download_default_template
/memberships/import_default/download_recap/<mimport_id>/	tendenci.apps.memberships.views.membership_default_import_download_recap	memberships.default_import_download_recap
/memberships/import_default/get_status/<mimport_id>/	tendenci.apps.memberships.views.membership_default_import_get_status	memberships.default_import_get_status
/memberships/import_default/preview/<mimport_id>/	tendenci.apps.memberships.views.membership_default_import_preview	memberships.default_import_preview
/memberships/import_default/process/<mimport_id>/	tendenci.apps.memberships.views.membership_default_import_process	memberships.default_import_process
/memberships/import_default/status/<mimport_id>/	tendenci.apps.memberships.views.membership_default_import_status	memberships.default_import_status
/memberships/notices/<id>/email_content/	tendenci.apps.memberships.views.notice_email_content	membership.notice_email_content
/memberships/notices/logs/<id>/	tendenci.apps.memberships.notices.views.membership_notice_log_view	membership.notice.log.view
/memberships/notices/logs/search/	tendenci.apps.memberships.notices.views.membership_notice_log_search	membership.notice.log.search
/memberships/referer-url/	tendenci.apps.memberships.views.referer_url	membership-referer-url
/memberships/reports/	tendenci.apps.memberships.views.report_list	reports-memberships
/memberships/reports/active_members/	tendenci.apps.memberships.views.report_active_members	reports-active-members
/memberships/reports/active_members_ytd/	tendenci.apps.memberships.views.report_active_members_ytd	reports-active-members-ytd
/memberships/reports/expired_members/	tendenci.apps.memberships.views.report_expired_members	reports-expired-members
/memberships/reports/join_summary	tendenci.apps.memberships.views.membership_join_report	reports-memberships-joins
/memberships/reports/member_quick_list/	tendenci.apps.memberships.views.report_member_quick_list	reports-members-quick-list
/memberships/reports/member_roster/	tendenci.apps.memberships.views.report_member_roster	reports-member-roster
/memberships/reports/members_by_company/	tendenci.apps.memberships.views.report_members_by_company	reports-members-by-company
/memberships/reports/members_donated/	tendenci.apps.memberships.views.report_members_donated	reports-members-donated
/memberships/reports/members_in_grace_period/	tendenci.apps.memberships.views.report_grace_period_members	reports-grace-period-members
/memberships/reports/members_in_renewal_period/	tendenci.apps.memberships.views.report_renewal_period_members	reports-renewal-period-members
/memberships/reports/members_over_time/	tendenci.apps.memberships.views.report_members_over_time	reports-members-over-time
/memberships/reports/members_stats/	tendenci.apps.memberships.views.report_members_stats	reports-members-stats
/memberships/reports/members_summary/	tendenci.apps.memberships.views.report_members_summary	reports-members-summary
/memberships/reports/members_ytd_type/	tendenci.apps.memberships.views.report_members_ytd_type	reports-members-ytd-type
/memberships/reports/overview/	tendenci.apps.memberships.views.memberships_overview	reports-memberships_overview
/memberships/reports/renewed_members/	tendenci.apps.memberships.views.report_renewed_members	reports-renewed-members
/memberships/search/	tendenci.apps.profiles.views.search	membership.search
/memberships/verifyemail/<id>/<guid>/	tendenci.apps.memberships.views.verify_email	membership.verify_email
/metrics/	tendenci.apps.metrics.views.index	metrics
/mobile/toggle_mobile_mode/	tendenci.apps.mobile.views.toggle_mobile_mode	toggle_mobile_mode
/model-report/	tendenci.libs.model_report.views.report_list	model_report_list
/model-report/<slug>/	tendenci.libs.model_report.views.report	model_report_view
/navs/	tendenci.apps.navs.views.search	navs.search
/navs/add/	tendenci.apps.navs.views.add	navs.add
/navs/delete/<id>/	tendenci.apps.navs.views.delete	navs.delete
/navs/detail/<id>/	tendenci.apps.navs.views.detail	navs.detail
/navs/edit/<id>/	tendenci.apps.navs.views.edit	navs.edit
/navs/edit/<id>/items/	tendenci.apps.navs.views.edit_items	navs.edit_items
/navs/export/	tendenci.apps.navs.views.export	navs.export
/navs/get-item-attrs/	tendenci.apps.navs.views.get_item_attrs	navs.get_item_attrs
/navs/page-select/	tendenci.apps.navs.views.page_select	navs.page_select
/news/	tendenci.apps.news.views.search	news
/news/<release_year>/	tendenci.apps.news.views.search	news_by_release_year
/news/<slug>/	tendenci.apps.news.views.detail	news.detail
/news/add/	tendenci.apps.news.views.add	news.add
/news/delete/<id>/	tendenci.apps.news.views.delete	news.delete
/news/edit/<id>/	tendenci.apps.news.views.edit	news.edit
/news/edit/meta/<id>/	tendenci.apps.news.views.edit_meta	news.edit.meta
/news/export/	tendenci.apps.news.views.export	news.export
/news/feed/	tendenci.apps.news.feeds.LatestEntriesFeed()	news.feed
/news/print-view/<slug>/	tendenci.apps.news.views.print_view	news.print_view
/news/search/	tendenci.apps.news.views.search_redirect	news.search
/newsletters/	tendenci.apps.newsletters.views.NewsletterListView	newsletter.list
/newsletters/actions/step1/<pk>/	tendenci.apps.newsletters.views.MarketingActionStepOneView	newsletter.action.step1
/newsletters/actions/step2/<pk>/	tendenci.apps.newsletters.views.MarketingActionStepTwoView	newsletter.action.step2
/newsletters/actions/step2/update-email/<pk>/	tendenci.apps.newsletters.views.NewsletterUpdateEmailView	newsletter.action.step2.update-email
/newsletters/actions/step3/<pk>/	tendenci.apps.newsletters.views.MarketingActionStepThreeView	newsletter.action.step3
/newsletters/actions/step4/<pk>/	tendenci.apps.newsletters.views.MarketingActionStepFourView	newsletter.action.step4
/newsletters/actions/step5/<pk>/	tendenci.apps.newsletters.views.MarketingActionStepFiveView	newsletter.action.step5
/newsletters/clone/<pk>/	tendenci.apps.newsletters.views.NewsletterCloneView	newsletter.clone
/newsletters/default_templates/view/	tendenci.apps.newsletters.views.default_template_view	newsletter.default_template
/newsletters/delete/<pk>/	tendenci.apps.newsletters.views.NewsletterDeleteView	newsletter.delete
/newsletters/generate/	tendenci.apps.newsletters.views.generate	newsletter.generate
/newsletters/newsletter_generator/	tendenci.apps.newsletters.views.NewsletterGeneratorView	newsletter.generator
/newsletters/newsletter_orig_generator/	tendenci.apps.newsletters.views.NewsletterGeneratorOrigView	newsletter.orig.generator
/newsletters/resend/<pk>/	tendenci.apps.newsletters.views.NewsletterResendView	newsletter.resend.view
/newsletters/templates/<template_id>/content/	tendenci.apps.newsletters.views.template_view	newsletter.template_content
/newsletters/templates/<template_id>/render/	tendenci.apps.newsletters.views.template_view	newsletter.template_render
/newsletters/view/<pk>/	tendenci.apps.newsletters.views.view_email_from_browser	newsletter.view_from_browser
/newsletters/view/details/<pk>/	tendenci.apps.newsletters.views.NewsletterDetailView	newsletter.detail.view
/notifications/	tendenci.apps.notifications.views.notices	notification_notices
/notifications/<guid>/	tendenci.apps.notifications.views.email	notification_email
/notifications/<var>/	tendenci.apps.notifications.views.single	notification_notice
/notifications/feed/	tendenci.apps.notifications.decorators.basic_auth	notification_feed_for_user
/notifications/mark_all_seen/	tendenci.apps.notifications.views.mark_all_seen	notification_mark_all_seen
/pages/	tendenci.apps.pages.views.index	pages
/pages/add/	tendenci.apps.pages.views.add	page.add
/pages/delete/<id>/	tendenci.apps.pages.views.delete	page.delete
/pages/edit/<id>/	tendenci.apps.pages.views.edit	page.edit
/pages/edit/meta/<id>/	tendenci.apps.pages.views.edit_meta	page.edit.meta
/pages/export/	tendenci.apps.pages.views.export	page.export
/pages/feed/	tendenci.apps.pages.feeds.LatestEntriesFeed()	page.feed
/pages/header_image/<id>/	tendenci.apps.pages.views.display_header_image	page.header_image
/pages/inactive/<id>/	tendenci.apps.pages.views.index	page.inactive
/pages/preview/	tendenci.apps.pages.views.preview	page.preview
/pages/preview/<id>/	tendenci.apps.pages.views.preview	page.preview
/pages/print-view/<slug>/	tendenci.apps.pages.views.print_view	page.print_view
/pages/search/	tendenci.apps.pages.views.search	page.search
/pages/versions/<hash>/	tendenci.apps.pages.views.index	page.version
/payments/<id>/<guid>	tendenci.apps.payments.views.view	payment.view
/payments/authorizenet/silent-post/	tendenci.apps.payments.authorizenet.views.silent_post	authorizenet.silent_post
/payments/authorizenet/thankyou/<payment_id>/	tendenci.apps.payments.authorizenet.views.sim_thank_you	authorizenet.sim_thank_you
/payments/firstdata/thankyou/<payment_id>/	tendenci.apps.payments.firstdata.views.thank_you	firstdata.thank_you
/payments/firstdatae4/silent-post/	tendenci.apps.payments.firstdatae4.views.silent_post	firstdatae4.silent_post
/payments/firstdatae4/thankyou/	tendenci.apps.payments.firstdatae4.views.thank_you	firstdatae4.thank_you
/payments/payflowlink/silentpost/	tendenci.apps.payments.payflowlink.views.silent_post	payflowlink.silent_post
/payments/payflowlink/thankyou/	tendenci.apps.payments.payflowlink.views.thank_you	payflowlink.thank_you
/payments/payonline/<invoice_id>/<guid>	tendenci.apps.payments.views.pay_online	payment.pay_online
/payments/payonline/<merchant_account>/<invoice_id>/<guid>	tendenci.apps.payments.views.pay_online	payment.pay_online
/payments/paypal/ipn/	tendenci.apps.payments.paypal.views.ipn	paypal.ipn
/payments/paypal/thankyou/	tendenci.apps.payments.paypal.views.thank_you	paypal.thank_you
/payments/receipt/<id>/<guid>	tendenci.apps.payments.views.receipt	payment.receipt
/payments/search/	tendenci.apps.payments.views.search	payment.search
/payments/stripe/connect/authorize/	tendenci.apps.payments.stripe.views.AuthorizeView	stripe_connect.authorize
/payments/stripe/connect/deauthorize/<sa_id>/	tendenci.apps.payments.stripe.views.DeauthorizeView	stripe_connect.deauthorize
/payments/stripe/connect/fetch-access-token/	tendenci.apps.payments.stripe.views.FetchAccessToken
/payments/stripe/connect/webhooks/	tendenci.apps.payments.stripe.views.WebhooksView	stripe_connect.webhooks
/payments/stripe/payonline/<payment_id>/<guid>/	tendenci.apps.payments.stripe.views.pay_online	stripe.payonline
/payments/stripe/thankyou/<payment_id>/<guid>/	tendenci.apps.payments.stripe.views.thank_you	stripe.thank_you
/payments/stripe/update-card/<rp_id>/	tendenci.apps.payments.stripe.views.update_card	stripe.update_card
/photos/	tendenci.apps.photos.views.photoset_view_latest	photoset_latest
/photos/<id>/	tendenci.apps.photos.views.photo	photo
/photos/<id>/<size>/	tendenci.apps.photos.views.photo_size	photo.size
/photos/<id>/<size>/<constrain>/	tendenci.apps.photos.views.photo_size	photo.size
/photos/<id>/<size>/<constrain>/<quality>/	tendenci.apps.photos.views.photo_size	photo.size
/photos/<id>/<size>/<crop>/	tendenci.apps.photos.views.photo_size	photo.size
/photos/<id>/<size>/<crop>/<quality>/	tendenci.apps.photos.views.photo_size	photo.size
/photos/<id>/in/<set_id>/	tendenci.apps.photos.views.photo	photo
/photos/<id>/original/	tendenci.apps.photos.views.photo_original	photo_original
/photos/batch-add/	tendenci.apps.photos.views.photos_batch_add	photos_batch_add
/photos/batch-add/<photoset_id>	tendenci.apps.photos.views.photos_batch_add	photos_batch_add
/photos/batch-edit/	tendenci.apps.photos.views.photos_batch_edit	photos.views.photos_batch_edit
/photos/batch-edit/<photoset_id>	tendenci.apps.photos.views.photos_batch_edit	photos_batch_edit
/photos/delete/<id>/	tendenci.apps.photos.views.delete	photo_destroy
/photos/delete/<id>/in/<set_id>/	tendenci.apps.photos.views.delete	photo_destroy
/photos/download/<id>/<size>/	tendenci.apps.photos.views.photo_size	photo_download
/photos/download/crop/<id>/<size>/	tendenci.apps.photos.views.photo_size	photo_crop_download
/photos/edit/<id>/	tendenci.apps.photos.views.edit	photo_edit
/photos/edit/<id>/in/<set_id>/	tendenci.apps.photos.views.edit	photo_edit
/photos/feeds/latest-albums/	tendenci.apps.photos.feeds.LatestAlbums()	photo.feed.latest-albums
/photos/partial/<id>/in/<set_id>/	tendenci.apps.photos.views.photo	photo_partial
/photos/search/	tendenci.apps.photos.views.search	photos_search
/photos/set/<id>/	tendenci.apps.photos.views.photoset_details	photoset_details
/photos/set/<id>/zip/	tendenci.apps.photos.views.photoset_zip	photoset_zip
/photos/set/<id>/zip/status/<task_id>/	tendenci.apps.photos.views.photoset_zip_status	photoset_zip_status
/photos/set/add/	tendenci.apps.photos.views.photoset_add	photoset_add
/photos/set/delete/<id>	tendenci.apps.photos.views.photoset_delete	photoset_delete
/photos/set/edit/<id>	tendenci.apps.photos.views.photoset_edit	photoset_edit
/photos/set/latest/	tendenci.apps.photos.views.photoset_view_latest	photoset_latest
/photos/sets/	tendenci.apps.photos.views.photoset_view_latest	photoset_latest
/photos/sizes/<id>/	tendenci.apps.photos.views.sizes	photo_sizes
/photos/sizes/large/<id>/	tendenci.apps.photos.views.sizes	photo_large
/photos/sizes/medium-500/<id>/	tendenci.apps.photos.views.sizes	photo_medium_500
/photos/sizes/medium-640/<id>/	tendenci.apps.photos.views.sizes	photo_medium_640
/photos/sizes/small/<id>/	tendenci.apps.photos.views.sizes	photo_small
/photos/sizes/square/<id>/	tendenci.apps.photos.views.sizes	photo_square
/photos/sizes/thumbnail/<id>/	tendenci.apps.photos.views.sizes	photo_thumbnail
/plugin-media/<plugin>/<path>	tendenci.apps.base.views.plugin_static_serve
/profiles/	tendenci.apps.profiles.views.index	profile.index
/profiles/<username>/	tendenci.apps.profiles.views.index	profile
/profiles/<username>/education/edit/	tendenci.apps.profiles.views.user_education_edit	profile.edit_education
/profiles/<username>/groups/<membership_id>/edit/	tendenci.apps.profiles.views.user_role_edit	profile.edit_role
/profiles/<username>/groups/edit/	tendenci.apps.profiles.views.user_groups_edit	profile.edit_groups
/profiles/<username>/memberships/add/	tendenci.apps.profiles.views.user_membership_add	profile.add_membership
/profiles/<username>/skills/	tendenci.apps.social_services.views.skill_list	user.skills
/profiles/<username>/skills/edit/	tendenci.apps.social_services.views.skill_list	user.skills_edit
/profiles/activate-email/	tendenci.apps.profiles.views.activate_email	profile.activate_email
/profiles/add/	tendenci.apps.profiles.views.add	profile.add
/profiles/admins/	tendenci.apps.profiles.views.admin_list	profile.admins
/profiles/delete/<id>/	tendenci.apps.profiles.views.delete	profile.delete
/profiles/edit/<id>/	tendenci.apps.profiles.views.edit	profile.edit
/profiles/edit_perms/<id>/	tendenci.apps.profiles.views.edit_user_perms	profile.edit_perms
/profiles/export/	tendenci.apps.base.decorators.decorator	profile.export
/profiles/export/download/<identifier>/	tendenci.apps.base.decorators.decorator	profile.export_download
/profiles/export/status/<identifier>/	tendenci.apps.base.decorators.decorator	profile.export_status
/profiles/import/	tendenci.apps.base.decorators.decorator	profiles.user_import
/profiles/import/check_encode_status/<uimport_id>/	tendenci.apps.profiles.views.user_import_check_preprocess_status	profiles.user_import_check_preprocess_status
/profiles/import/download/	tendenci.apps.profiles.views.download_user_template	profiles.download_user_template
/profiles/import/download_recap/<uimport_id>/	tendenci.apps.profiles.views.user_import_download_recap	profiles.user_import_download_recap
/profiles/import/get_status/<uimport_id>/	tendenci.apps.profiles.views.user_import_get_status	profiles.user_import_get_status
/profiles/import/preview/<uimport_id>/	tendenci.apps.profiles.views.user_import_preview	profiles.user_import_preview
/profiles/import/process/<uimport_id>/	tendenci.apps.profiles.views.user_import_process	profiles.user_import_process
/profiles/import/status/<uimport_id>/	tendenci.apps.profiles.views.user_import_status	profiles.user_import_status
/profiles/merge/<sid>/	tendenci.apps.base.decorators.decorator	profile.merge_view
/profiles/search/	tendenci.apps.profiles.views.search	profile.search
/profiles/similar/	tendenci.apps.profiles.views.similar_profiles	profile.similar
/proxy/<url>	httpproxy.views.HttpProxy
/py/	tendenci.apps.make_payments.views.add	make_payment.add
/py/<id>/	tendenci.apps.make_payments.views.view	make_payment.view
/py/conf/<id>/	tendenci.apps.make_payments.views.add_confirm	make_payment.add_confirm
/redirects/	tendenci.apps.redirects.views.search	redirects
/redirects/add/	tendenci.apps.redirects.views.add	redirect.add
/redirects/delete/<id>/	tendenci.apps.redirects.views.delete	redirect.delete
/redirects/edit/<id>/	tendenci.apps.redirects.views.edit	redirect.edit
/redirects/export/	tendenci.apps.redirects.views.export	redirect.export
/reports/	tendenci.apps.reports.views.ReportListView	report_list
/reports/<pk>/	tendenci.apps.reports.views.ReportDetailView	report_detail
/reports/<report_id>/runs/<pk>/	tendenci.apps.reports.views.RunDetailView	report_run_detail
/reports/<report_id>/runs/<pk>/output/	tendenci.apps.reports.views.RunOutputView	report_run_output
/reports/<report_id>/runs/add/	tendenci.apps.reports.views.RunCreateView	report_run_create
/reports/add/	tendenci.apps.reports.views.ReportCreateView	report_create
/resumes/	tendenci.apps.resumes.views.search	resumes
/resumes/<slug>/	tendenci.apps.resumes.views.index	resume
/resumes/<slug>/file/	tendenci.apps.resumes.views.resume_file	resume.resume_file
/resumes/add/	tendenci.apps.resumes.views.add	resume.add
/resumes/approve/<id>/	tendenci.apps.resumes.views.approve	resume.approve
/resumes/delete/<id>/	tendenci.apps.resumes.views.delete	resume.delete
/resumes/edit/<id>/	tendenci.apps.resumes.views.edit	resume.edit
/resumes/edit/meta/<id>/	tendenci.apps.resumes.views.edit_meta	resume.edit.meta
/resumes/export/	tendenci.apps.resumes.views.export	resume.export
/resumes/feed/	tendenci.apps.resumes.feeds.LatestEntriesFeed()	resume.feed
/resumes/pending/	tendenci.apps.resumes.views.pending	resume.pending
/resumes/print-view/<slug>/	tendenci.apps.resumes.views.print_view	resume.print_view
/resumes/search/	tendenci.apps.resumes.views.search_redirect	resume.search
/resumes/thank-you/	tendenci.apps.resumes.views.thank_you	resume.thank_you
/robots.txt	tendenci.apps.base.views.robots_txt	robots
/rp/	tendenci.apps.base.decorators.decorator	recurring_payment.my_accounts
/rp/<recurring_payment_id>/<guid>	tendenci.apps.base.decorators.decorator	recurring_payment.view_account
/rp/<username>/	tendenci.apps.base.decorators.decorator	recurring_payment.my_accounts
/rp/authnet/empty/	django.views.generic.base.TemplateView
/rp/authnet/iframe_communicator/	django.views.generic.base.TemplateView	recurring_payment.authnet.iframe_communicator
/rp/authnet/manage_payment_info/<recurring_payment_id>/	tendenci.apps.recurring_payments.authnet.views.manage_payment_info	recurring_payment.authnet.manage_payment_info
/rp/authnet/retrieve_token/	tendenci.apps.recurring_payments.authnet.views.retrieve_token	recurring_payment.authnet.retrieve_token
/rp/authnet/update_payment_info/<recurring_payment_id>/	tendenci.apps.base.decorators.decorator	recurring_payment.authnet.update_payment_info
/rp/authnet/update_payment_profile_local/	tendenci.apps.recurring_payments.authnet.views.update_payment_profile_local	recurring_payment.authnet.update_payment_profile_local
/rp/customers/	tendenci.apps.recurring_payments.views.customers	recurring_payment.customers
/rp/disable/<rp_id>/	tendenci.apps.recurring_payments.views.disable_account	recurring_payment.disable_account
/rp/receipt/<rp_id>/<payment_transaction_id>/<rp_guid>	tendenci.apps.recurring_payments.views.transaction_receipt	recurring_payment.transaction_receipt
/rp/run_now/	tendenci.apps.recurring_payments.views.run_now	recurring_payment.run_now
/rss/	tendenci.apps.rss.feeds.GlobalFeed()	rss.mainrssfeed
/search/	tendenci.apps.search.views.SearchView()	haystack_search
/search/open-search/	tendenci.apps.search.views.open_search	open_search
/settings/	tendenci.apps.site_settings.views.index	settings
/settings/<scope>/<scope_category>/	tendenci.apps.site_settings.views.list	settings.index
/settings/<scope>/<scope_category>/#id_<var>	tendenci.apps.site_settings.views.list	setting.permalink
/settings/<scope>/<scope_category>/<name>/	tendenci.apps.site_settings.views.single_setting	settings.single_setting
/sitemap.xml	tendenci.apps.sitemaps.views.create_sitemap
/sitemap/	django.views.generic.base.TemplateView	site_map
/social-services/map/	tendenci.apps.social_services.views.relief_map	social-services.map
/social-services/relief-area/<area_id>/	tendenci.apps.social_services.views.relief_area_detail	social-services.relief_area
/social-services/relief-areas/	tendenci.apps.social_services.views.relief_areas_list	social-services.relief_areas
/social-services/relief-assessment/form/	tendenci.apps.social_services.views.relief_form	social-services.form
/social-services/responders/	tendenci.apps.social_services.views.responders_list	social-services.responders
/speakers/	tendenci.apps.speakers.views.search	speakers
/speakers/<slug>/	tendenci.apps.speakers.views.details	speaker.view
/speakers/feed/	tendenci.apps.speakers.feeds.LatestEntriesFeed()	speaker.feed
/speakers/search/	tendenci.apps.speakers.views.search_redirect	speaker.search
/staff/	tendenci.apps.staff.views.search	staff
/staff/<slug>/	tendenci.apps.staff.views.detail	staff.view
/staff/<slug>/<cv>/	tendenci.apps.staff.views.detail	staff.cv
/staff/department/<slug>/	tendenci.apps.staff.views.search	staff.department_view
/staff/feed/	tendenci.apps.staff.feeds.LatestEntriesFeed()	staff.feed
/staff/search/	tendenci.apps.staff.views.search_redirect	staff.search
/static/<path>	django.contrib.staticfiles.views.serve
/static/<path>	django.views.static.serve
/stories/	tendenci.apps.stories.views.search	stories
/stories/<id>/	tendenci.apps.stories.views.details	story
/stories/add/	tendenci.apps.stories.views.add	story.add
/stories/delete/<id>/	tendenci.apps.stories.views.delete	story.delete
/stories/edit/<id>/	tendenci.apps.stories.views.edit	story.edit
/stories/export/	tendenci.apps.stories.views.export	story.export
/stories/feed/	tendenci.apps.stories.feeds.LatestEntriesFeed()	story.feed
/stories/print/<id>/	tendenci.apps.stories.views.print_details	story.print_details
/stories/search/	tendenci.apps.stories.views.search_redirect	story.search
/study-groups/	tendenci.apps.studygroups.views.search	studygroups.search
/study-groups/<slug>/	tendenci.apps.studygroups.views.detail	studygroups.detail
/study-groups/add/	tendenci.apps.studygroups.views.add	studygroups.add
/study-groups/delete/<id>/	tendenci.apps.studygroups.views.delete	studygroups.delete
/study-groups/edit/<id>/	tendenci.apps.studygroups.views.edit	studygroups.edit
/study-groups/edit/meta/<id>/	tendenci.apps.studygroups.views.edit_meta	studygroups.edit.meta
/study-groups/feed/	tendenci.apps.studygroups.feeds.LatestEntriesFeed()	studygroups.feed
/tag-test/	django.views.generic.base.TemplateView	tag_test
/tags/	tendenci.apps.tags.views.tags_list	tags_list
/tags/<id>/	tendenci.apps.tags.views.detail	tag.detail
/tags/autocomplete/	tendenci.apps.tags.views.autocomplete	tag.autocomplete
/tendenci/guide/<slug>/	tendenci.apps.tendenci_guide.views.guide_page	tendenci_guide.guide_page
/testimonials/	tendenci.apps.testimonials.views.search	testimonials
/testimonials/<pk>/	tendenci.apps.testimonials.views.details	testimonial.view
/testimonials/feed/	tendenci.apps.testimonials.feeds.LatestEntriesFeed()	testimonial.feed
/testimonials/search/	tendenci.apps.testimonials.views.search_redirect	testimonial.search
/theme-editor/apps/	tendenci.apps.theme_editor.views.app_list	theme_editor.app_list
/theme-editor/copy_to_theme/	tendenci.apps.theme_editor.views.copy_to_theme	theme_editor.copy_to_theme
/theme-editor/create_template/	tendenci.apps.theme_editor.views.create_new_template	theme_editor.create_new_template
/theme-editor/delete/	tendenci.apps.theme_editor.views.delete_file	theme_editor.delete
/theme-editor/editor/	tendenci.apps.theme_editor.views.edit_file	theme_editor.editor
/theme-editor/get-version/<var>/	tendenci.apps.theme_editor.views.get_version	theme_editor.get_version
/theme-editor/templates/	tendenci.apps.theme_editor.views.original_templates	theme_editor.original_templates
/theme-editor/theme/copy/	tendenci.apps.theme_editor.views.theme_copy	theme_editor.theme_copy
/theme-editor/theme/delete/	tendenci.apps.theme_editor.views.theme_delete	theme_editor.theme_delete
/theme-editor/theme/rename/	tendenci.apps.theme_editor.views.theme_rename	theme_editor.theme_rename
/theme-editor/theme_color/	tendenci.apps.theme_editor.views.theme_color	theme_editor.color
/theme-editor/theme_picker/	tendenci.apps.theme_editor.views.theme_picker	theme_editor.picker
/theme-editor/themes/get/	tendenci.apps.theme_editor.views.get_themes	theme_editor.get_themes
/theme-editor/upload/	tendenci.apps.theme_editor.views.upload_file	theme_editor.upload
/themes/<path>	django.views.static.serve
/tinymce/compressor/	tendenci.libs.tinymce.views.compressor	tinymce-compressor
/tinymce/filebrowser/	tendenci.libs.tinymce.views.filebrowser	tinymce-filebrowser
/tinymce/flatpages_link_list/	tendenci.libs.tinymce.views.flatpages_link_list
/tinymce/js/textareas/<name>/	tendenci.libs.tinymce.views.textareas_js	tinymce-js
/tinymce/js/textareas/<name>/<lang>	tendenci.libs.tinymce.views.textareas_js	tinymce-js-lang
/tinymce/preview/<name>/	tendenci.libs.tinymce.views.preview	tinymce-preview
/tinymce/spellchecker/	tendenci.libs.tinymce.views.spell_check	tinymce-spellcheck
/users/<username>/	django.views.generic.base.RedirectView
/users/reports/active-logins/	tendenci.apps.profiles.views.user_access_report	reports-user-access
/users/reports/admin/	tendenci.apps.profiles.views.admin_users_report	reports-admin-users
/users/reports/contacts-referral/	tendenci.apps.user_groups.views.users_added_report	reports-contacts-referral
/users/reports/not-in-groups/	tendenci.apps.profiles.views.users_not_in_groups	reports-users-not-in-groups
/users/reports/users-activity-top10/	tendenci.apps.profiles.views.user_activity_report	reports-user-activity
/users/reports/users-added/	tendenci.apps.user_groups.views.users_added_report	reports-user-added
/versions/<ct>/<object_id>/	tendenci.apps.versions.views.version_list	versions
/videos/	tendenci.apps.videos.views.search	video
/videos/<var>/	tendenci.apps.videos.views.detail	video.details
/videos/category/<var>/	tendenci.apps.videos.views.index	video.category
/videos/feed/	tendenci.apps.videos.feeds.LatestEntriesFeed()	video.feed
/videos/search/	tendenci.apps.videos.views.search	video.search
/wp_exporter/	tendenci.apps.wp_exporter.views.index	wp_exporter
/wp_exporter/detail/<task_id>/	tendenci.apps.wp_exporter.views.detail	export_detail
/wp_exporter/download/<export_id>/	tendenci.apps.wp_exporter.views.download
/wp_importer/	tendenci.apps.wp_importer.views.index
/wp_importer/detail/<task_id>/	tendenci.apps.wp_importer.views.detail	detail
